Open,Close,Diff.,Diff. Dec.,Diff. %,Result
-205,-210,-5,0.024390244,2.43902439,0
-105,-127,-22,0.20952381,20.95238095,1
-210,-230,-20,0.095238095,9.523809524,1
-210,-215,-5,0.023809524,2.380952381,0
-115,-122,-7,0.060869565,6.086956522,0
-165,-185,-20,0.121212121,12.12121212,0
170,165,-5,-0.029411765,2.941176471,1
149,140,-9,-0.060402685,6.040268456,0
-115,-118,-3,0.026086957,2.608695652,0
-105,-108,-3,0.028571429,2.857142857,0
-105,-109,-4,0.038095238,3.80952381,1
-140,-150,-10,0.071428571,7.142857143,1
-105,-118,-13,0.123809524,12.38095238,0
243,210,-33,-0.135802469,13.58024691,0
213,190,-23,-0.107981221,10.79812207,0
109,-119,-228,-2.091743119,25.68807339,0
115,114,-1,-0.008695652,0.869565217,1
120,-109,-229,-1.908333333,24.16666667,0
-110,-114,-4,0.036363636,3.636363636,0
-165,-172,-7,0.042424242,4.242424242,0
144,149,5,0.034722222,3.472222222,0
100,-112,-212,-2.12,12,0
-110,-118,-8,0.072727273,7.272727273,1
-225,-220,5,-0.022222222,2.222222222,1
-210,-210,0,0,0,1
163,152,-11,-0.067484663,6.748466258,0
151,142,-9,-0.059602649,5.960264901,1
155,156,1,0.006451613,0.64516129,1
-165,-162,3,-0.018181818,1.818181818,1
115,118,3,0.026086957,2.608695652,0
110,105,-5,-0.045454545,4.545454545,1
105,-104,-209,-1.99047619,8.571428571,1
-115,-130,-15,0.130434783,13.04347826,0
105,105,0,0,0,1
120,102,-18,-0.15,15,1
-110,-112,-2,0.018181818,1.818181818,0
-170,-186,-16,0.094117647,9.411764706,1
207,190,-17,-0.082125604,8.212560386,0
1124,180,-944,-0.839857651,66.19217082,1
-160,-178,-18,0.1125,11.25,0
130,120,-10,-0.076923077,7.692307692,0
-165,-170,-5,0.03030303,3.03030303,0
151,150,-1,-0.006622517,0.662251656,1
-110,-116,-6,0.054545455,5.454545455,0
-120,-124,-4,0.033333333,3.333333333,1
100,-105,-205,-2.05,5,0
-110,-116,-6,0.054545455,5.454545455,0
-140,-151,-11,0.078571429,7.857142857,1
184,173,-11,-0.059782609,5.97826087,1
100,100,0,0,0,0
155,132,-23,-0.148387097,14.83870968,1
-130,-152,-22,0.169230769,16.92307692,1
140,135,-5,-0.035714286,3.571428571,0
-105,-125,-20,0.19047619,19.04761905,0
-210,-230,-20,0.095238095,9.523809524,1
-110,-113,-3,0.027272727,2.727272727,0
105,105,0,0,0,0
-120,-123,-3,0.025,2.5,1
-155,-155,0,0,0,1
135,106,-29,-0.214814815,21.48148148,0
-115,-127,-12,0.104347826,10.43478261,0
-150,-155,-5,0.033333333,3.333333333,1
120,113,-7,-0.058333333,5.833333333,0
100,103,3,0.03,3,1
120,113,-7,-0.058333333,5.833333333,1
192,170,-22,-0.114583333,11.45833333,0
135,130,-5,-0.037037037,3.703703704,1
-110,-108,2,-0.018181818,1.818181818,0
245,245,0,0,0,0
-150,-155,-5,0.033333333,3.333333333,0
-130,-137,-7,0.053846154,5.384615385,0
-145,-150,-5,0.034482759,3.448275862,1
163,158,-5,-0.030674847,3.067484663,0
-190,-200,-10,0.052631579,5.263157895,1
-110,-108,2,-0.018181818,1.818181818,1
-160,-170,-10,0.0625,6.25,1
-130,-164,-34,0.261538462,26.15384615,1
100,-115,-215,-2.15,15,1
-150,-148,2,-0.013333333,1.333333333,0
100,-118,-218,-2.18,18,0
-175,-170,5,-0.028571429,2.857142857,1
100,-112,-212,-2.12,12,1
-185,-185,0,0,0,1
-190,-185,5,-0.026315789,2.631578947,0
135,132,-3,-0.022222222,2.222222222,1
170,175,5,0.029411765,2.941176471,1
163,155,-8,-0.049079755,4.90797546,1
130,122,-8,-0.061538462,6.153846154,1
163,165,2,0.012269939,1.226993865,0
-151,-150,1,-0.006622517,0.662251656,1
-125,-127,-2,0.016,1.6,1
-140,-140,0,0,0,0
155,138,-17,-0.109677419,10.96774194,0
-180,-216,-36,0.2,20,1
-155,-165,-10,0.064516129,6.451612903,1
-110,-109,1,-0.009090909,0.909090909,0
-165,-166,-1,0.006060606,0.606060606,1
-130,-151,-21,0.161538462,16.15384615,1
-260,-280,-20,0.076923077,7.692307692,1
-115,-125,-10,0.086956522,8.695652174,1
-111,-143,-32,0.288288288,28.82882883,1
125,119,-6,-0.048,4.8,1
-117,-125,-8,0.068376068,6.837606838,1
-180,-185,-5,0.027777778,2.777777778,1
-170,-172,-2,0.011764706,1.176470588,0
-175,-187,-12,0.068571429,6.857142857,1
-275,-270,5,-0.018181818,1.818181818,0
100,-112,-212,-2.12,12,0
-160,-170,-10,0.0625,6.25,1
144,147,3,0.020833333,2.083333333,1
130,124,-6,-0.046153846,4.615384615,0
115,112,-3,-0.026086957,2.608695652,1
176,157,-19,-0.107954545,10.79545455,0
-135,-138,-3,0.022222222,2.222222222,0
-190,-185,5,-0.026315789,2.631578947,0
100,-101,-201,-2.01,1,0
140,141,1,0.007142857,0.714285714,1
155,150,-5,-0.032258065,3.225806452,0
115,117,2,0.017391304,1.739130435,0
148,143,-5,-0.033783784,3.378378378,0
140,122,-18,-0.128571429,12.85714286,1
-130,-130,0,0,0,0
-120,-125,-5,0.041666667,4.166666667,1
163,140,-23,-0.141104294,14.11042945,0
100,-102,-202,-2.02,2,1
-140,-163,-23,0.164285714,16.42857143,0
-140,-140,0,0,0,1
163,150,-13,-0.079754601,7.975460123,0
134,128,-6,-0.044776119,4.47761194,0
-185,-180,5,-0.027027027,2.702702703,0
120,102,-18,-0.15,15,1
148,150,2,0.013513514,1.351351351,0
188,178,-10,-0.053191489,5.319148936,0
149,124,-25,-0.167785235,16.77852349,1
135,116,-19,-0.140740741,14.07407407,0
131,128,-3,-0.022900763,2.290076336,1
114,101,-13,-0.114035088,11.40350877,1
-195,-192,3,-0.015384615,1.538461538,1
-205,-205,0,0,0,1
135,115,-20,-0.148148148,14.81481481,0
118,101,-17,-0.144067797,14.40677966,0
-240,-250,-10,0.041666667,4.166666667,0
110,115,5,0.045454545,4.545454545,0
-215,-240,-25,0.11627907,11.62790698,0
105,-150,-255,-2.428571429,52.38095238,1
163,148,-15,-0.09202454,9.202453988,1
-145,-143,2,-0.013793103,1.379310345,0
-101,-106,-5,0.04950495,4.95049505,0
-101,-101,0,0,0,0
274,280,6,0.02189781,2.189781022,0
130,112,-18,-0.138461538,13.84615385,1
120,120,0,0,0,0
105,103,-2,-0.019047619,1.904761905,0
155,153,-2,-0.012903226,1.290322581,1
-125,-132,-7,0.056,5.6,0
-110,-113,-3,0.027272727,2.727272727,0
-170,-176,-6,0.035294118,3.529411765,0
-108,-105,3,-0.027777778,2.777777778,0
105,109,4,0.038095238,3.80952381,1
158,126,-32,-0.202531646,20.25316456,1
105,106,1,0.00952381,0.952380952,1
-170,-174,-4,0.023529412,2.352941176,1
-110,-118,-8,0.072727273,7.272727273,0
192,176,-16,-0.083333333,8.333333333,1
110,104,-6,-0.054545455,5.454545455,1
-200,-250,-50,0.25,25,0
-260,-255,5,-0.019230769,1.923076923,1
-120,-140,-20,0.166666667,16.66666667,0
-130,-126,4,-0.030769231,3.076923077,0
125,120,-5,-0.04,4,1
-180,-189,-9,0.05,5,0
192,168,-24,-0.125,12.5,1
-110,-111,-1,0.009090909,0.909090909,1
-143,-145,-2,0.013986014,1.398601399,0
151,147,-4,-0.026490066,2.649006623,0
155,135,-20,-0.129032258,12.90322581,0
-160,-172,-12,0.075,7.5,0
245,240,-5,-0.020408163,2.040816327,0
140,125,-15,-0.107142857,10.71428571,0
-130,-155,-25,0.192307692,19.23076923,0
-170,-180,-10,0.058823529,5.882352941,0
-120,-115,5,-0.041666667,4.166666667,1
-160,-176,-16,0.1,10,1
103,-102,-205,-1.990291262,4.854368932,0
-133,-135,-2,0.015037594,1.503759398,0
-105,-110,-5,0.047619048,4.761904762,0
170,176,6,0.035294118,3.529411765,0
-130,-144,-14,0.107692308,10.76923077,1
-131,-130,1,-0.007633588,0.763358779,0
144,131,-13,-0.090277778,9.027777778,1
144,137,-7,-0.048611111,4.861111111,0
-110,-159,-49,0.445454545,44.54545455,0
105,109,4,0.038095238,3.80952381,1
146,116,-30,-0.205479452,20.54794521,0
-165,-185,-20,0.121212121,12.12121212,1
100,-102,-202,-2.02,2,1
-110,-117,-7,0.063636364,6.363636364,1
100,-113,-213,-2.13,13,1
115,101,-14,-0.12173913,12.17391304,1
110,-108,-218,-1.981818182,16.36363636,0
-120,-130,-10,0.083333333,8.333333333,1
130,119,-11,-0.084615385,8.461538462,0
-120,-118,2,-0.016666667,1.666666667,0
125,106,-19,-0.152,15.2,0
110,-105,-215,-1.954545455,13.63636364,0
110,-105,-215,-1.954545455,13.63636364,0
-122,-127,-5,0.040983607,4.098360656,1
-130,-128,2,-0.015384615,1.538461538,1
-133,-135,-2,0.015037594,1.503759398,0
125,118,-7,-0.056,5.6,0
-140,-137,3,-0.021428571,2.142857143,1
-275,-280,-5,0.018181818,1.818181818,1
102,-115,-217,-2.12745098,16.66666667,0
-176,-176,0,0,0,1
192,132,-60,-0.3125,31.25,1
-126,-138,-12,0.095238095,9.523809524,0
-180,-200,-20,0.111111111,11.11111111,0
-175,-180,-5,0.028571429,2.857142857,1
120,115,-5,-0.041666667,4.166666667,1
-143,-140,3,-0.020979021,2.097902098,0
-235,-250,-15,0.063829787,6.382978723,0
-107,-108,-1,0.009345794,0.934579439,0
115,-112,-227,-1.973913043,23.47826087,1
-110,-110,0,0,0,0
-130,-150,-20,0.153846154,15.38461538,1
-110,-122,-12,0.109090909,10.90909091,0
-145,-155,-10,0.068965517,6.896551724,1
-110,-115,-5,0.045454545,4.545454545,1
-110,-108,2,-0.018181818,1.818181818,1
-110,-105,5,-0.045454545,4.545454545,1
-135,-165,-30,0.222222222,22.22222222,0
-110,-115,-5,0.045454545,4.545454545,0
100,-102,-202,-2.02,2,1
-210,-220,-10,0.047619048,4.761904762,0
172,178,6,0.034883721,3.488372093,1
-130,-142,-12,0.092307692,9.230769231,1
-110,-111,-1,0.009090909,0.909090909,1
140,135,-5,-0.035714286,3.571428571,1
120,115,-5,-0.041666667,4.166666667,1
105,-112,-217,-2.066666667,16.19047619,1
100,-102,-202,-2.02,2,0
-105,-107,-2,0.019047619,1.904761905,0
-103,-105,-2,0.019417476,1.941747573,1
176,169,-7,-0.039772727,3.977272727,0
-105,-116,-11,0.104761905,10.47619048,0
176,175,-1,-0.005681818,0.568181818,0
-120,-118,2,-0.016666667,1.666666667,1
125,108,-17,-0.136,13.6,1
103,102,-1,-0.009708738,0.970873786,1
113,105,-8,-0.07079646,7.079646018,0
-120,-120,0,0,0,1
160,149,-11,-0.06875,6.875,0
-200,-196,4,-0.02,2,0
-170,-168,2,-0.011764706,1.176470588,0
115,113,-2,-0.017391304,1.739130435,1
100,-112,-212,-2.12,12,1
-160,-172,-12,0.075,7.5,0
-126,-128,-2,0.015873016,1.587301587,0
-110,-110,0,0,0,0
-135,-155,-20,0.148148148,14.81481481,1
-135,-140,-5,0.037037037,3.703703704,0
-130,-140,-10,0.076923077,7.692307692,0
-121,-123,-2,0.016528926,1.652892562,0
-121,-133,-12,0.099173554,9.917355372,1
135,132,-3,-0.022222222,2.222222222,1
122,-110,-232,-1.901639344,26.2295082,1
131,130,-1,-0.007633588,0.763358779,0
157,159,2,0.012738854,1.27388535,1
-110,-112,-2,0.018181818,1.818181818,0
153,154,1,0.006535948,0.653594771,1
114,114,0,0,0,0
104,105,1,0.009615385,0.961538462,1
-142,-158,-16,0.112676056,11.26760563,1
-271,-300,-29,0.10701107,10.70110701,1
-125,-155,-30,0.24,24,1
105,-104,-209,-1.99047619,8.571428571,1
120,113,-7,-0.058333333,5.833333333,0
-125,-134,-9,0.072,7.2,1
140,136,-4,-0.028571429,2.857142857,1
-130,-127,3,-0.023076923,2.307692308,1
-130,-141,-11,0.084615385,8.461538462,1
-130,-154,-24,0.184615385,18.46153846,1
120,100,-20,-0.166666667,16.66666667,0
-150,-161,-11,0.073333333,7.333333333,0
-130,-160,-30,0.230769231,23.07692308,1
125,129,4,0.032,3.2,0
-145,-153,-8,0.055172414,5.517241379,1
-101,-110,-9,0.089108911,8.910891089,1
105,-105,-210,-2,9.523809524,0
-190,-186,4,-0.021052632,2.105263158,0
-155,-174,-19,0.122580645,12.25806452,1
144,137,-7,-0.048611111,4.861111111,1
140,136,-4,-0.028571429,2.857142857,0
-190,-194,-4,0.021052632,2.105263158,0
-115,-114,1,-0.008695652,0.869565217,1
-145,-147,-2,0.013793103,1.379310345,1
-105,-120,-15,0.142857143,14.28571429,1
-115,-137,-22,0.191304348,19.13043478,1
-150,-158,-8,0.053333333,5.333333333,1
-165,-170,-5,0.03030303,3.03030303,1
-200,-210,-10,0.05,5,0
135,135,0,0,0,0
-120,-125,-5,0.041666667,4.166666667,1
120,122,2,0.016666667,1.666666667,0
-115,-110,5,-0.043478261,4.347826087,1
-150,-156,-6,0.04,4,1
110,114,4,0.036363636,3.636363636,1
120,113,-7,-0.058333333,5.833333333,1
175,175,0,0,0,0
-125,-126,-1,0.008,0.8,0
115,105,-10,-0.086956522,8.695652174,0
110,106,-4,-0.036363636,3.636363636,0
175,165,-10,-0.057142857,5.714285714,0
-135,-138,-3,0.022222222,2.222222222,0
175,170,-5,-0.028571429,2.857142857,1
115,119,4,0.034782609,3.47826087,1
165,170,5,0.03030303,3.03030303,1
-165,-198,-33,0.2,20,1
150,153,3,0.02,2,1
-110,-107,3,-0.027272727,2.727272727,1
-165,-165,0,0,0,1
-170,-185,-15,0.088235294,8.823529412,0
-110,-105,5,-0.045454545,4.545454545,1
-120,-119,1,-0.008333333,0.833333333,0
150,150,0,0,0,1
100,-102,-202,-2.02,2,0
145,150,5,0.034482759,3.448275862,0
-165,-177,-12,0.072727273,7.272727273,1
145,150,5,0.034482759,3.448275862,0
140,135,-5,-0.035714286,3.571428571,0
-110,-109,1,-0.009090909,0.909090909,0
140,138,-2,-0.014285714,1.428571429,1
-170,-165,5,-0.029411765,2.941176471,0
-225,-260,-35,0.155555556,15.55555556,0
-110,-113,-3,0.027272727,2.727272727,0
-170,-176,-6,0.035294118,3.529411765,1
105,-112,-217,-2.066666667,16.19047619,1
135,142,7,0.051851852,5.185185185,1
-235,-245,-10,0.042553191,4.255319149,0
-180,-190,-10,0.055555556,5.555555556,1
-105,-113,-8,0.076190476,7.619047619,1
130,107,-23,-0.176923077,17.69230769,1
-150,-146,4,-0.026666667,2.666666667,0
-110,-113,-3,0.027272727,2.727272727,1
-200,-210,-10,0.05,5,1
-135,-133,2,-0.014814815,1.481481481,1
100,-105,-205,-2.05,5,1
-160,-156,4,-0.025,2.5,1
-135,-142,-7,0.051851852,5.185185185,1
-125,-122,3,-0.024,2.4,1
150,137,-13,-0.086666667,8.666666667,0
-170,-170,0,0,0,1
110,115,5,0.045454545,4.545454545,0
-220,-210,10,-0.045454545,4.545454545,1
110,115,5,0.045454545,4.545454545,0
-250,-270,-20,0.08,8,0
-165,-176,-11,0.066666667,6.666666667,0
115,107,-8,-0.069565217,6.956521739,1
125,120,-5,-0.04,4,1
-160,-200,-40,0.25,25,0
135,118,-17,-0.125925926,12.59259259,0
-170,-180,-10,0.058823529,5.882352941,0
-110,-112,-2,0.018181818,1.818181818,0
-160,-160,0,0,0,0
115,-101,-216,-1.87826087,13.91304348,1
175,180,5,0.028571429,2.857142857,0
-140,-146,-6,0.042857143,4.285714286,1
100,-116,-216,-2.16,16,0
-145,-160,-15,0.103448276,10.34482759,0
-110,-125,-15,0.136363636,13.63636364,0
-125,-120,5,-0.04,4,1
110,-108,-218,-1.981818182,16.36363636,1
-125,-125,0,0,0,1
-200,-196,4,-0.02,2,1
-350,-400,-50,0.142857143,14.28571429,1
-125,-126,-1,0.008,0.8,1
145,145,0,0,0,0
-135,-140,-5,0.037037037,3.703703704,1
125,128,3,0.024,2.4,0
-130,-129,1,-0.007692308,0.769230769,0
-145,-148,-3,0.020689655,2.068965517,0
-115,-120,-5,0.043478261,4.347826087,1
-125,-147,-22,0.176,17.6,1
-160,-155,5,-0.03125,3.125,0
100,-103,-203,-2.03,3,1
-135,-150,-15,0.111111111,11.11111111,1
-115,-125,-10,0.086956522,8.695652174,0
-180,-172,8,-0.044444444,4.444444444,0
-170,-174,-4,0.023529412,2.352941176,1
-210,-215,-5,0.023809524,2.380952381,1
-115,-144,-29,0.252173913,25.2173913,0
145,152,7,0.048275862,4.827586207,0
-170,-185,-15,0.088235294,8.823529412,0
-110,-109,1,-0.009090909,0.909090909,1
-180,-174,6,-0.033333333,3.333333333,0
-140,-136,4,-0.028571429,2.857142857,1
-140,-138,2,-0.014285714,1.428571429,0
-145,-153,-8,0.055172414,5.517241379,1
120,120,0,0,0,0
-160,-162,-2,0.0125,1.25,1
-190,-200,-10,0.052631579,5.263157895,1
130,132,2,0.015384615,1.538461538,0
-170,-180,-10,0.058823529,5.882352941,0
-115,-125,-10,0.086956522,8.695652174,0
-250,-240,10,-0.04,4,1
115,115,0,0,0,1
-165,-158,7,-0.042424242,4.242424242,0
-180,-210,-30,0.166666667,16.66666667,1
125,110,-15,-0.12,12,1
-190,-200,-10,0.052631579,5.263157895,1
-140,-154,-14,0.1,10,0
120,115,-5,-0.041666667,4.166666667,1
-110,-110,0,0,0,0
-130,-130,0,0,0,1
-185,-178,7,-0.037837838,3.783783784,1
155,163,8,0.051612903,5.161290323,0
-105,-112,-7,0.066666667,6.666666667,1
-110,-148,-38,0.345454545,34.54545455,1
-110,-120,-10,0.090909091,9.090909091,1
120,115,-5,-0.041666667,4.166666667,1
-140,-145,-5,0.035714286,3.571428571,1
110,114,4,0.036363636,3.636363636,0
165,155,-10,-0.060606061,6.060606061,0
-235,-245,-10,0.042553191,4.255319149,0
-110,-115,-5,0.045454545,4.545454545,1
160,160,0,0,0,0
-145,-155,-10,0.068965517,6.896551724,0
-125,-137,-12,0.096,9.6,0
-115,-113,2,-0.017391304,1.739130435,0
-115,-120,-5,0.043478261,4.347826087,1
110,111,1,0.009090909,0.909090909,0
105,-111,-216,-2.057142857,15.23809524,0
-110,-125,-15,0.136363636,13.63636364,0
170,160,-10,-0.058823529,5.882352941,1
-220,-230,-10,0.045454545,4.545454545,0
-135,-153,-18,0.133333333,13.33333333,0
-115,-112,3,-0.026086957,2.608695652,1
130,101,-29,-0.223076923,22.30769231,0
-135,-131,4,-0.02962963,2.962962963,1
120,122,2,0.016666667,1.666666667,1
155,149,-6,-0.038709677,3.870967742,1
210,202,-8,-0.038095238,3.80952381,0
-110,-112,-2,0.018181818,1.818181818,0
-135,-131,4,-0.02962963,2.962962963,1
165,164,-1,-0.006060606,0.606060606,1
-165,-176,-11,0.066666667,6.666666667,0
150,144,-6,-0.04,4,0
105,-104,-209,-1.99047619,8.571428571,1
-130,-132,-2,0.015384615,1.538461538,0
-130,-126,4,-0.030769231,3.076923077,1
-110,-116,-6,0.054545455,5.454545455,0
-120,-115,5,-0.041666667,4.166666667,0
-120,-119,1,-0.008333333,0.833333333,0
-105,-102,3,-0.028571429,2.857142857,0
105,-113,-218,-2.076190476,17.14285714,1
-140,-137,3,-0.021428571,2.142857143,1
170,175,5,0.029411765,2.941176471,1
185,177,-8,-0.043243243,4.324324324,0
170,162,-8,-0.047058824,4.705882353,1
-135,-133,2,-0.014814815,1.481481481,0
130,120,-10,-0.076923077,7.692307692,0
-135,-144,-9,0.066666667,6.666666667,0
-140,-148,-8,0.057142857,5.714285714,1
120,118,-2,-0.016666667,1.666666667,0
115,118,3,0.026086957,2.608695652,0
130,132,2,0.015384615,1.538461538,1
-210,-210,0,0,0,1
-135,-142,-7,0.051851852,5.185185185,0
135,142,7,0.051851852,5.185185185,0
-145,-146,-1,0.006896552,0.689655172,1
-105,-119,-14,0.133333333,13.33333333,0
135,134,-1,-0.007407407,0.740740741,0
-130,-141,-11,0.084615385,8.461538462,1
125,117,-8,-0.064,6.4,0
160,160,0,0,0,1
-130,-139,-9,0.069230769,6.923076923,0
-170,-166,4,-0.023529412,2.352941176,0
-180,-185,-5,0.027777778,2.777777778,1
-180,-190,-10,0.055555556,5.555555556,1
-130,-133,-3,0.023076923,2.307692308,0
105,105,0,0,0,0
-135,-145,-10,0.074074074,7.407407407,1
150,147,-3,-0.02,2,0
125,115,-10,-0.08,8,1
-180,-180,0,0,0,0
-110,-108,2,-0.018181818,1.818181818,1
125,124,-1,-0.008,0.8,0
-145,-140,5,-0.034482759,3.448275862,0
155,156,1,0.006451613,0.64516129,0
105,102,-3,-0.028571429,2.857142857,0
-115,-111,4,-0.034782609,3.47826087,1
135,133,-2,-0.014814815,1.481481481,0
-130,-137,-7,0.053846154,5.384615385,0
270,270,0,0,0,0
-140,-146,-6,0.042857143,4.285714286,1
155,149,-6,-0.038709677,3.870967742,1
-125,-130,-5,0.04,4,1
-110,-105,5,-0.045454545,4.545454545,0
125,120,-5,-0.04,4,0
135,132,-3,-0.022222222,2.222222222,0
-150,-150,0,0,0,1
-130,-130,0,0,0,1
-115,-120,-5,0.043478261,4.347826087,0
-150,-150,0,0,0,1
-185,-180,5,-0.027027027,2.702702703,0
-140,-155,-15,0.107142857,10.71428571,1
110,108,-2,-0.018181818,1.818181818,0
125,122,-3,-0.024,2.4,1
-170,-180,-10,0.058823529,5.882352941,0
-135,-138,-3,0.022222222,2.222222222,1
-115,-118,-3,0.026086957,2.608695652,1
-115,-120,-5,0.043478261,4.347826087,0
-125,-125,0,0,0,0
160,153,-7,-0.04375,4.375,0
-110,-111,-1,0.009090909,0.909090909,1
-130,-129,1,-0.007692308,0.769230769,0
120,110,-10,-0.083333333,8.333333333,1
105,109,4,0.038095238,3.80952381,0
100,102,2,0.02,2,0
-135,-148,-13,0.096296296,9.62962963,1
-150,-145,5,-0.033333333,3.333333333,1
-180,-185,-5,0.027777778,2.777777778,1
-140,-156,-16,0.114285714,11.42857143,1
130,-107,-237,-1.823076923,28.46153846,1
215,210,-5,-0.023255814,2.325581395,0
-160,-167,-7,0.04375,4.375,1
140,138,-2,-0.014285714,1.428571429,0
115,116,1,0.008695652,0.869565217,0
-160,-177,-17,0.10625,10.625,1
-125,-125,0,0,0,0
-135,-150,-15,0.111111111,11.11111111,0
135,136,1,0.007407407,0.740740741,1
175,175,0,0,0,0
-130,-130,0,0,0,1
-125,-160,-35,0.28,28,1
155,161,6,0.038709677,3.870967742,0
-115,-130,-15,0.130434783,13.04347826,1
100,-110,-210,-2.1,10,0
-250,-260,-10,0.04,4,1
145,146,1,0.006896552,0.689655172,1
100,-110,-210,-2.1,10,1
-130,-135,-5,0.038461538,3.846153846,0
135,135,0,0,0,0
-130,-157,-27,0.207692308,20.76923077,0
-120,-125,-5,0.041666667,4.166666667,1
100,-105,-205,-2.05,5,0
115,116,1,0.008695652,0.869565217,0
-105,-101,4,-0.038095238,3.80952381,0
120,106,-14,-0.116666667,11.66666667,1
-200,-200,0,0,0,1
115,110,-5,-0.043478261,4.347826087,0
-150,-155,-5,0.033333333,3.333333333,0
-150,-184,-34,0.226666667,22.66666667,0
-125,-134,-9,0.072,7.2,0
-110,-105,5,-0.045454545,4.545454545,0
170,171,1,0.005882353,0.588235294,0
-220,-229,-9,0.040909091,4.090909091,1
-150,-168,-18,0.12,12,1
185,176,-9,-0.048648649,4.864864865,1
160,158,-2,-0.0125,1.25,0
105,101,-4,-0.038095238,3.80952381,0
-210,-216,-6,0.028571429,2.857142857,1
160,156,-4,-0.025,2.5,0
100,102,2,0.02,2,0
115,102,-13,-0.113043478,11.30434783,1
-140,-146,-6,0.042857143,4.285714286,1
-160,-157,3,-0.01875,1.875,1
-140,-144,-4,0.028571429,2.857142857,0
115,110,-5,-0.043478261,4.347826087,1
100,100,0,0,0,0
150,159,9,0.06,6,0
-120,-124,-4,0.033333333,3.333333333,0
115,107,-8,-0.069565217,6.956521739,0
260,250,-10,-0.038461538,3.846153846,0
-140,-135,5,-0.035714286,3.571428571,1
-110,-113,-3,0.027272727,2.727272727,0
150,144,-6,-0.04,4,0
-190,-189,1,-0.005263158,0.526315789,0
155,145,-10,-0.064516129,6.451612903,0
100,-101,-201,-2.01,1,1
-125,-142,-17,0.136,13.6,1
-125,-152,-27,0.216,21.6,0
130,133,3,0.023076923,2.307692308,1
-160,-170,-10,0.0625,6.25,1
-115,-130,-15,0.130434783,13.04347826,1
105,-105,-210,-2,9.523809524,0
145,135,-10,-0.068965517,6.896551724,1
100,-105,-205,-2.05,5,0
125,100,-25,-0.2,20,0
145,150,5,0.034482759,3.448275862,1
-150,-154,-4,0.026666667,2.666666667,0
155,155,0,0,0,0
-110,-112,-2,0.018181818,1.818181818,0
-160,-170,-10,0.0625,6.25,1
-200,-200,0,0,0,0
-150,-192,-42,0.28,28,1
-140,-142,-2,0.014285714,1.428571429,1
-105,-105,0,0,0,1
130,120,-10,-0.076923077,7.692307692,1
-130,-158,-28,0.215384615,21.53846154,0
-130,-154,-24,0.184615385,18.46153846,1
-195,-207,-12,0.061538462,6.153846154,1
-195,-215,-20,0.102564103,10.25641026,1
-105,-110,-5,0.047619048,4.761904762,0
235,230,-5,-0.021276596,2.127659574,1
-120,-135,-15,0.125,12.5,1
-165,-170,-5,0.03030303,3.03030303,0
110,107,-3,-0.027272727,2.727272727,1
155,162,7,0.04516129,4.516129032,0
-145,-147,-2,0.013793103,1.379310345,0
-105,-105,0,0,0,1
130,110,-20,-0.153846154,15.38461538,0
-250,-260,-10,0.04,4,1
-210,-210,0,0,0,1
-150,-150,0,0,0,1
125,112,-13,-0.104,10.4,0
-120,-145,-25,0.208333333,20.83333333,0
145,133,-12,-0.082758621,8.275862069,0
115,100,-15,-0.130434783,13.04347826,1
-105,-116,-11,0.104761905,10.47619048,0
105,103,-2,-0.019047619,1.904761905,1
165,160,-5,-0.03030303,3.03030303,1
-255,-300,-45,0.176470588,17.64705882,1
-120,-118,2,-0.016666667,1.666666667,1
110,109,-1,-0.009090909,0.909090909,1
-150,-194,-44,0.293333333,29.33333333,1
-140,-156,-16,0.114285714,11.42857143,1
-220,-220,0,0,0,1
-315,-310,5,-0.015873016,1.587301587,1
125,115,-10,-0.08,8,0
-110,-106,4,-0.036363636,3.636363636,1
105,103,-2,-0.019047619,1.904761905,1
-170,-168,2,-0.011764706,1.176470588,1
110,106,-4,-0.036363636,3.636363636,1
-110,-121,-11,0.1,10,1
-130,-148,-18,0.138461538,13.84615385,0
-170,-196,-26,0.152941176,15.29411765,0
-140,-145,-5,0.035714286,3.571428571,0
110,-102,-212,-1.927272727,10.90909091,0
105,-107,-212,-2.019047619,11.42857143,1
-195,-209,-14,0.071794872,7.179487179,0
-190,-200,-10,0.052631579,5.263157895,1
135,140,5,0.037037037,3.703703704,0
115,105,-10,-0.086956522,8.695652174,0
-115,-117,-2,0.017391304,1.739130435,1
105,-110,-215,-2.047619048,14.28571429,1
120,109,-11,-0.091666667,9.166666667,0
115,109,-6,-0.052173913,5.217391304,1
110,-105,-215,-1.954545455,13.63636364,1
-115,-129,-14,0.12173913,12.17391304,0
-190,-190,0,0,0,1
-110,-124,-14,0.127272727,12.72727273,1
-145,-149,-4,0.027586207,2.75862069,1
135,111,-24,-0.177777778,17.77777778,0
-110,-110,0,0,0,1
-110,-129,-19,0.172727273,17.27272727,0
-145,-154,-9,0.062068966,6.206896552,1
-125,-124,1,-0.008,0.8,0
-145,-164,-19,0.131034483,13.10344828,0
105,-110,-215,-2.047619048,14.28571429,0
175,176,1,0.005714286,0.571428571,0
145,136,-9,-0.062068966,6.206896552,1
-210,-215,-5,0.023809524,2.380952381,1
-110,-112,-2,0.018181818,1.818181818,0
-145,-154,-9,0.062068966,6.206896552,0
-200,-200,0,0,0,1
155,141,-14,-0.090322581,9.032258065,0
145,141,-4,-0.027586207,2.75862069,0
-110,-121,-11,0.1,10,0
-200,-200,0,0,0,1
155,160,5,0.032258065,3.225806452,1
-145,-145,0,0,0,1
155,152,-3,-0.019354839,1.935483871,0
-120,-115,5,-0.041666667,4.166666667,0
130,124,-6,-0.046153846,4.615384615,0
135,137,2,0.014814815,1.481481481,0
120,120,0,0,0,0
180,177,-3,-0.016666667,1.666666667,0
-145,-146,-1,0.006896552,0.689655172,1
105,105,0,0,0,0
-180,-210,-30,0.166666667,16.66666667,1
130,120,-10,-0.076923077,7.692307692,0
-130,-130,0,0,0,1
-130,-129,1,-0.007692308,0.769230769,0
-125,-149,-24,0.192,19.2,1
160,156,-4,-0.025,2.5,1
-135,-137,-2,0.014814815,1.481481481,0
135,132,-3,-0.022222222,2.222222222,0
145,132,-13,-0.089655172,8.965517241,1
-115,-120,-5,0.043478261,4.347826087,0
-125,-125,0,0,0,1
-180,-180,0,0,0,1
-235,-280,-45,0.191489362,19.14893617,1
-125,-135,-10,0.08,8,1
-130,-137,-7,0.053846154,5.384615385,0
-115,-115,0,0,0,1
-110,-108,2,-0.018181818,1.818181818,1
-115,-126,-11,0.095652174,9.565217391,0
-110,-106,4,-0.036363636,3.636363636,0
-160,-168,-8,0.05,5,0
-160,-180,-20,0.125,12.5,1
130,124,-6,-0.046153846,4.615384615,0
-130,-143,-13,0.1,10,0
-170,-205,-35,0.205882353,20.58823529,0
210,210,0,0,0,0
-125,-125,0,0,0,0
150,147,-3,-0.02,2,0
-165,-163,2,-0.012121212,1.212121212,0
-140,-142,-2,0.014285714,1.428571429,1
-170,-185,-15,0.088235294,8.823529412,0
175,171,-4,-0.022857143,2.285714286,0
-150,-170,-20,0.133333333,13.33333333,1
-170,-166,4,-0.023529412,2.352941176,0
-105,-102,3,-0.028571429,2.857142857,0
125,104,-21,-0.168,16.8,0
120,118,-2,-0.016666667,1.666666667,0
130,114,-16,-0.123076923,12.30769231,0
145,148,3,0.020689655,2.068965517,1
110,107,-3,-0.027272727,2.727272727,0
115,104,-11,-0.095652174,9.565217391,0
170,175,5,0.029411765,2.941176471,0
-180,-174,6,-0.033333333,3.333333333,1
110,-112,-222,-2.018181818,20,0
-125,-123,2,-0.016,1.6,0
175,180,5,0.028571429,2.857142857,0
-185,-215,-30,0.162162162,16.21621622,0
-115,-137,-22,0.191304348,19.13043478,1
-150,-156,-6,0.04,4,0
-140,-140,0,0,0,0
-140,-142,-2,0.014285714,1.428571429,1
120,105,-15,-0.125,12.5,1
115,105,-10,-0.086956522,8.695652174,0
-130,-143,-13,0.1,10,1
150,150,0,0,0,0
150,152,2,0.013333333,1.333333333,0
-210,-210,0,0,0,1
-140,-198,-58,0.414285714,41.42857143,1
-105,-105,0,0,0,0
130,110,-20,-0.153846154,15.38461538,1
-125,-124,1,-0.008,0.8,1
120,115,-5,-0.041666667,4.166666667,0
-120,-138,-18,0.15,15,1
130,116,-14,-0.107692308,10.76923077,1
-145,-180,-35,0.24137931,24.13793103,1
-110,-127,-17,0.154545455,15.45454545,0
-185,-209,-24,0.12972973,12.97297297,0
-145,-164,-19,0.131034483,13.10344828,1
-250,-280,-30,0.12,12,0
-140,-158,-18,0.128571429,12.85714286,0
-145,-145,0,0,0,1
105,106,1,0.00952381,0.952380952,0
-145,-158,-13,0.089655172,8.965517241,1
105,-116,-221,-2.104761905,20,0
-105,-101,4,-0.038095238,3.80952381,0
-185,-186,-1,0.005405405,0.540540541,0
140,135,-5,-0.035714286,3.571428571,1
130,133,3,0.023076923,2.307692308,0
150,143,-7,-0.046666667,4.666666667,0
135,120,-15,-0.111111111,11.11111111,1
135,115,-20,-0.148148148,14.81481481,1
100,-106,-206,-2.06,6,0
100,-116,-216,-2.16,16,1
-145,-163,-18,0.124137931,12.4137931,1
-150,-148,2,-0.013333333,1.333333333,1
-105,-121,-16,0.152380952,15.23809524,1
-125,-120,5,-0.04,4,0
-120,-134,-14,0.116666667,11.66666667,1
-115,-110,5,-0.043478261,4.347826087,0
195,190,-5,-0.025641026,2.564102564,0
-170,-174,-4,0.023529412,2.352941176,1
105,102,-3,-0.028571429,2.857142857,1
-110,-118,-8,0.072727273,7.272727273,0
105,-113,-218,-2.076190476,17.14285714,0
150,150,0,0,0,1
100,-112,-212,-2.12,12,1
-160,-185,-25,0.15625,15.625,0
120,118,-2,-0.016666667,1.666666667,1
220,185,-35,-0.159090909,15.90909091,0
130,126,-4,-0.030769231,3.076923077,1
140,130,-10,-0.071428571,7.142857143,0
-105,-140,-35,0.333333333,33.33333333,1
-110,-115,-5,0.045454545,4.545454545,1
-110,-105,5,-0.045454545,4.545454545,1
-140,-158,-18,0.128571429,12.85714286,0
105,-102,-207,-1.971428571,6.666666667,0
140,127,-13,-0.092857143,9.285714286,1
-170,-190,-20,0.117647059,11.76470588,1
-180,-182,-2,0.011111111,1.111111111,1
165,155,-10,-0.060606061,6.060606061,0
150,144,-6,-0.04,4,0
-120,-131,-11,0.091666667,9.166666667,0
150,155,5,0.033333333,3.333333333,0
-135,-134,1,-0.007407407,0.740740741,0
100,-108,-208,-2.08,8,0
105,100,-5,-0.047619048,4.761904762,1
-235,-290,-55,0.234042553,23.40425532,1
-135,-148,-13,0.096296296,9.62962963,1
-165,-192,-27,0.163636364,16.36363636,1
-110,-111,-1,0.009090909,0.909090909,0
125,127,2,0.016,1.6,1
-105,-123,-18,0.171428571,17.14285714,1
105,104,-1,-0.00952381,0.952380952,1
-180,-192,-12,0.066666667,6.666666667,0
-160,-153,7,-0.04375,4.375,1
-170,-166,4,-0.023529412,2.352941176,0
-130,-132,-2,0.015384615,1.538461538,0
-125,-160,-35,0.28,28,1
-140,-148,-8,0.057142857,5.714285714,1
140,142,2,0.014285714,1.428571429,0
-150,-162,-12,0.08,8,0
155,152,-3,-0.019354839,1.935483871,0
110,-106,-216,-1.963636364,14.54545455,0
-150,-150,0,0,0,0
-115,-118,-3,0.026086957,2.608695652,1
105,-113,-218,-2.076190476,17.14285714,0
140,141,1,0.007142857,0.714285714,1
-235,-230,5,-0.021276596,2.127659574,1
135,121,-14,-0.103703704,10.37037037,1
-125,-130,-5,0.04,4,1
120,122,2,0.016666667,1.666666667,0
-145,-155,-10,0.068965517,6.896551724,1
-150,-162,-12,0.08,8,1
105,-110,-215,-2.047619048,14.28571429,0
130,120,-10,-0.076923077,7.692307692,0
100,-105,-205,-2.05,5,1
-180,-172,8,-0.044444444,4.444444444,1
-125,-141,-16,0.128,12.8,0
110,112,2,0.018181818,1.818181818,0
-180,-187,-7,0.038888889,3.888888889,1
185,178,-7,-0.037837838,3.783783784,1
120,103,-17,-0.141666667,14.16666667,1
-210,-206,4,-0.019047619,1.904761905,1
110,108,-2,-0.018181818,1.818181818,0
-150,-153,-3,0.02,2,0
-105,-130,-25,0.238095238,23.80952381,1
-110,-107,3,-0.027272727,2.727272727,1
100,-104,-204,-2.04,4,1
-125,-136,-11,0.088,8.8,1
175,181,6,0.034285714,3.428571429,0
-130,-128,2,-0.015384615,1.538461538,0
-105,-103,2,-0.019047619,1.904761905,0
-185,-180,5,-0.027027027,2.702702703,1
-110,-107,3,-0.027272727,2.727272727,1
100,-104,-204,-2.04,4,1
-130,-132,-2,0.015384615,1.538461538,0
120,114,-6,-0.05,5,1
-125,-127,-2,0.016,1.6,1
145,143,-2,-0.013793103,1.379310345,0
155,155,0,0,0,0
-130,-139,-9,0.069230769,6.923076923,1
125,104,-21,-0.168,16.8,0
125,110,-15,-0.12,12,1
115,105,-10,-0.086956522,8.695652174,0
-235,-230,5,-0.021276596,2.127659574,1
130,119,-11,-0.084615385,8.461538462,1
150,148,-2,-0.013333333,1.333333333,0
110,109,-1,-0.009090909,0.909090909,0
-235,-230,5,-0.021276596,2.127659574,0
100,-103,-203,-2.03,3,1
130,135,5,0.038461538,3.846153846,0
-110,-125,-15,0.136363636,13.63636364,0
105,-109,-214,-2.038095238,13.33333333,0
-125,-136,-11,0.088,8.8,0
-130,-150,-20,0.153846154,15.38461538,1
110,115,5,0.045454545,4.545454545,0
-125,-122,3,-0.024,2.4,1
120,112,-8,-0.066666667,6.666666667,0
120,125,5,0.041666667,4.166666667,1
-245,-250,-5,0.020408163,2.040816327,1
110,110,0,0,0,1
-115,-110,5,-0.043478261,4.347826087,1
-140,-148,-8,0.057142857,5.714285714,0
-110,-112,-2,0.018181818,1.818181818,0
100,-102,-202,-2.02,2,1
-130,-135,-5,0.038461538,3.846153846,0
185,185,0,0,0,0
-125,-127,-2,0.016,1.6,1
-150,-150,0,0,0,0
-145,-145,0,0,0,0
100,-105,-205,-2.05,5,1
105,105,0,0,0,0
-135,-147,-12,0.088888889,8.888888889,1
-165,-185,-20,0.121212121,12.12121212,1
165,172,7,0.042424242,4.242424242,0
-160,-156,4,-0.025,2.5,0
-135,-141,-6,0.044444444,4.444444444,0
-165,-185,-20,0.121212121,12.12121212,1
-170,-183,-13,0.076470588,7.647058824,0
-115,-130,-15,0.130434783,13.04347826,1
-115,-121,-6,0.052173913,5.217391304,1
-140,-143,-3,0.021428571,2.142857143,1
-110,-111,-1,0.009090909,0.909090909,1
-145,-159,-14,0.096551724,9.655172414,1
115,102,-13,-0.113043478,11.30434783,1
-200,-230,-30,0.15,15,1
125,130,5,0.04,4,0
160,150,-10,-0.0625,6.25,0
-210,-230,-20,0.095238095,9.523809524,1
-200,-260,-60,0.3,30,0
-130,-128,2,-0.015384615,1.538461538,1
-165,-178,-13,0.078787879,7.878787879,1
-110,-117,-7,0.063636364,6.363636364,1
-115,-113,2,-0.017391304,1.739130435,0
-130,-131,-1,0.007692308,0.769230769,0
-130,-125,5,-0.038461538,3.846153846,0
-180,-184,-4,0.022222222,2.222222222,1
-145,-149,-4,0.027586207,2.75862069,0
-130,-149,-19,0.146153846,14.61538462,1
-110,-108,2,-0.018181818,1.818181818,1
175,175,0,0,0,0
130,117,-13,-0.1,10,0
-150,-167,-17,0.113333333,11.33333333,0
-120,-130,-10,0.083333333,8.333333333,1
-220,-230,-10,0.045454545,4.545454545,1
100,-102,-202,-2.02,2,0
-135,-132,3,-0.022222222,2.222222222,1
-180,-203,-23,0.127777778,12.77777778,1
-110,-117,-7,0.063636364,6.363636364,1
-105,-106,-1,0.00952381,0.952380952,0
100,102,2,0.02,2,1
-135,-138,-3,0.022222222,2.222222222,0
-140,-142,-2,0.014285714,1.428571429,0
-135,-147,-12,0.088888889,8.888888889,1
150,158,8,0.053333333,5.333333333,1
110,106,-4,-0.036363636,3.636363636,1
-170,-165,5,-0.029411765,2.941176471,1
185,180,-5,-0.027027027,2.702702703,0
-270,-300,-30,0.111111111,11.11111111,1
-160,-178,-18,0.1125,11.25,1
145,136,-9,-0.062068966,6.206896552,0
-160,-154,6,-0.0375,3.75,1
110,100,-10,-0.090909091,9.090909091,0
135,127,-8,-0.059259259,5.925925926,0
120,118,-2,-0.016666667,1.666666667,0
-135,-139,-4,0.02962963,2.962962963,1
-270,-310,-40,0.148148148,14.81481481,1
-140,-150,-10,0.071428571,7.142857143,1
-300,-290,10,-0.033333333,3.333333333,1
150,145,-5,-0.033333333,3.333333333,1
-120,-138,-18,0.15,15,0
-165,-172,-7,0.042424242,4.242424242,1
115,105,-10,-0.086956522,8.695652174,0
-145,-150,-5,0.034482759,3.448275862,1
-170,-174,-4,0.023529412,2.352941176,1
-115,-118,-3,0.026086957,2.608695652,0
-120,-115,5,-0.041666667,4.166666667,1
190,190,0,0,0,0
-105,-101,4,-0.038095238,3.80952381,1
-120,-121,-1,0.008333333,0.833333333,0
115,107,-8,-0.069565217,6.956521739,0
255,236,-19,-0.074509804,7.450980392,1
-160,-162,-2,0.0125,1.25,0
110,-104,-214,-1.945454545,12.72727273,1
-130,-126,4,-0.030769231,3.076923077,1
-130,-126,4,-0.030769231,3.076923077,0
140,144,4,0.028571429,2.857142857,0
180,164,-16,-0.088888889,8.888888889,0
125,114,-11,-0.088,8.8,0
195,205,10,0.051282051,5.128205128,1
-110,-129,-19,0.172727273,17.27272727,1
195,200,5,0.025641026,2.564102564,0
-185,-178,7,-0.037837838,3.783783784,1
-130,-145,-15,0.115384615,11.53846154,1
-195,-192,3,-0.015384615,1.538461538,1
115,116,1,0.008695652,0.869565217,0
200,180,-20,-0.1,10,0
115,119,4,0.034782609,3.47826087,0
-125,-125,0,0,0,1
-110,-130,-20,0.181818182,18.18181818,1
-140,-135,5,-0.035714286,3.571428571,0
-165,-200,-35,0.212121212,21.21212121,1
135,140,5,0.037037037,3.703703704,1
170,162,-8,-0.047058824,4.705882353,0
165,158,-7,-0.042424242,4.242424242,0
-160,-158,2,-0.0125,1.25,1
-125,-134,-9,0.072,7.2,1
100,-122,-222,-2.22,22,1
-145,-144,1,-0.006896552,0.689655172,0
130,130,0,0,0,0
125,130,5,0.04,4,1
-160,-160,0,0,0,1
130,122,-8,-0.061538462,6.153846154,0
-105,-103,2,-0.019047619,1.904761905,1
-115,-125,-10,0.086956522,8.695652174,1
-235,-240,-5,0.021276596,2.127659574,0
170,163,-7,-0.041176471,4.117647059,0
155,143,-12,-0.077419355,7.741935484,0
-125,-122,3,-0.024,2.4,0
-170,-165,5,-0.029411765,2.941176471,1
130,120,-10,-0.076923077,7.692307692,1
-190,-185,5,-0.026315789,2.631578947,1
100,104,4,0.04,4,0
-130,-128,2,-0.015384615,1.538461538,1
-115,-130,-15,0.130434783,13.04347826,0
105,-115,-220,-2.095238095,19.04761905,0
-105,-113,-8,0.076190476,7.619047619,1
-140,-136,4,-0.028571429,2.857142857,0
-180,-200,-20,0.111111111,11.11111111,0
145,152,7,0.048275862,4.827586207,0
275,255,-20,-0.072727273,7.272727273,0
155,160,5,0.032258065,3.225806452,0
135,137,2,0.014814815,1.481481481,1
-130,-125,5,-0.038461538,3.846153846,1
130,132,2,0.015384615,1.538461538,1
115,108,-7,-0.060869565,6.086956522,0
145,148,3,0.020689655,2.068965517,0
145,148,3,0.020689655,2.068965517,0
200,204,4,0.02,2,0
-115,-132,-17,0.147826087,14.7826087,1
-150,-147,3,-0.02,2,0
185,190,5,0.027027027,2.702702703,0
110,103,-7,-0.063636364,6.363636364,1
-180,-182,-2,0.011111111,1.111111111,1
155,144,-11,-0.070967742,7.096774194,1
-170,-176,-6,0.035294118,3.529411765,1
130,106,-24,-0.184615385,18.46153846,0
105,-104,-209,-1.99047619,8.571428571,0
-135,-130,5,-0.037037037,3.703703704,1
190,199,9,0.047368421,4.736842105,0
150,160,10,0.066666667,6.666666667,1
-110,-129,-19,0.172727273,17.27272727,1
150,141,-9,-0.06,6,0
145,149,4,0.027586207,2.75862069,1
165,166,1,0.006060606,0.606060606,1
190,178,-12,-0.063157895,6.315789474,0
-130,-138,-8,0.061538462,6.153846154,1
-190,-186,4,-0.021052632,2.105263158,1
-140,-138,2,-0.014285714,1.428571429,0
-165,-200,-35,0.212121212,21.21212121,0
-160,-155,5,-0.03125,3.125,1
135,137,2,0.014814815,1.481481481,1
-110,-107,3,-0.027272727,2.727272727,1
-200,-205,-5,0.025,2.5,1
-110,-109,1,-0.009090909,0.909090909,1
130,119,-11,-0.084615385,8.461538462,1
-115,-125,-10,0.086956522,8.695652174,0
-120,-126,-6,0.05,5,0
-110,-115,-5,0.045454545,4.545454545,0
-110,-116,-6,0.054545455,5.454545455,1
160,139,-21,-0.13125,13.125,0
105,-115,-220,-2.095238095,19.04761905,0
-220,-230,-10,0.045454545,4.545454545,1
-130,-125,5,-0.038461538,3.846153846,1
110,-102,-212,-1.927272727,10.90909091,1
145,145,0,0,0,0
110,104,-6,-0.054545455,5.454545455,0
110,113,3,0.027272727,2.727272727,0
-200,-206,-6,0.03,3,1
-130,-140,-10,0.076923077,7.692307692,0
120,103,-17,-0.141666667,14.16666667,1
105,-114,-219,-2.085714286,18.0952381,1
-135,-143,-8,0.059259259,5.925925926,1
-135,-132,3,-0.022222222,2.222222222,1
135,112,-23,-0.17037037,17.03703704,0
145,117,-28,-0.193103448,19.31034483,0
160,161,1,0.00625,0.625,0
175,163,-12,-0.068571429,6.857142857,0
-135,-139,-4,0.02962963,2.962962963,1
120,122,2,0.016666667,1.666666667,1
125,126,1,0.008,0.8,0
-115,-122,-7,0.060869565,6.086956522,1
145,150,5,0.034482759,3.448275862,1
-145,-155,-10,0.068965517,6.896551724,0
-135,-132,3,-0.022222222,2.222222222,0
-115,-114,1,-0.008695652,0.869565217,0
-115,-130,-15,0.130434783,13.04347826,1
-170,-260,-90,0.529411765,52.94117647,1
130,129,-1,-0.007692308,0.769230769,0
-125,-122,3,-0.024,2.4,0
-130,-132,-2,0.015384615,1.538461538,1
-160,-163,-3,0.01875,1.875,1
110,108,-2,-0.018181818,1.818181818,1
125,128,3,0.024,2.4,1
110,102,-8,-0.072727273,7.272727273,1
105,-101,-206,-1.961904762,5.714285714,1
-110,-106,4,-0.036363636,3.636363636,1
130,129,-1,-0.007692308,0.769230769,0
-115,-124,-9,0.07826087,7.826086957,0
-275,-265,10,-0.036363636,3.636363636,0
-185,-188,-3,0.016216216,1.621621622,1
-110,-116,-6,0.054545455,5.454545455,0
125,118,-7,-0.056,5.6,0
-105,-122,-17,0.161904762,16.19047619,0
-170,-164,6,-0.035294118,3.529411765,0
-105,-113,-8,0.076190476,7.619047619,0
105,105,0,0,0,1
-200,-200,0,0,0,1
-120,-124,-4,0.033333333,3.333333333,0
-145,-158,-13,0.089655172,8.965517241,1
-105,-109,-4,0.038095238,3.80952381,0
-170,-215,-45,0.264705882,26.47058824,1
-110,-138,-28,0.254545455,25.45454545,1
-110,-112,-2,0.018181818,1.818181818,1
-160,-205,-45,0.28125,28.125,1
-160,-174,-14,0.0875,8.75,1
130,134,4,0.030769231,3.076923077,0
135,128,-7,-0.051851852,5.185185185,1
145,147,2,0.013793103,1.379310345,0
105,105,0,0,0,1
-115,-118,-3,0.026086957,2.608695652,1
100,100,0,0,0,0
-110,-117,-7,0.063636364,6.363636364,1
-115,-119,-4,0.034782609,3.47826087,1
-120,-131,-11,0.091666667,9.166666667,1
-150,-154,-4,0.026666667,2.666666667,0
-210,-250,-40,0.19047619,19.04761905,0
-190,-200,-10,0.052631579,5.263157895,1
140,135,-5,-0.035714286,3.571428571,0
-170,-188,-18,0.105882353,10.58823529,1
-200,-230,-30,0.15,15,1
110,101,-9,-0.081818182,8.181818182,0
-170,-183,-13,0.076470588,7.647058824,0
-235,-280,-45,0.191489362,19.14893617,1
110,110,0,0,0,0
-145,-145,0,0,0,0
-135,-140,-5,0.037037037,3.703703704,1
105,101,-4,-0.038095238,3.80952381,1
-170,-168,2,-0.011764706,1.176470588,0
-270,-310,-40,0.148148148,14.81481481,1
-170,-174,-4,0.023529412,2.352941176,1
-225,-255,-30,0.133333333,13.33333333,0
-160,-162,-2,0.0125,1.25,1
-125,-123,2,-0.016,1.6,0
-105,-120,-15,0.142857143,14.28571429,1
110,112,2,0.018181818,1.818181818,0
-180,-200,-20,0.111111111,11.11111111,0
-115,-111,4,-0.034782609,3.47826087,0
-160,-155,5,-0.03125,3.125,1
175,161,-14,-0.08,8,0
100,-107,-207,-2.07,7,1
-120,-120,0,0,0,1
-260,-255,5,-0.019230769,1.923076923,1
-190,-204,-14,0.073684211,7.368421053,1
-270,-260,10,-0.037037037,3.703703704,0
-270,-270,0,0,0,1
135,139,4,0.02962963,2.962962963,0
145,143,-2,-0.013793103,1.379310345,0
-120,-119,1,-0.008333333,0.833333333,1
105,108,3,0.028571429,2.857142857,0
215,185,-30,-0.139534884,13.95348837,1
245,205,-40,-0.163265306,16.32653061,0
135,130,-5,-0.037037037,3.703703704,1
110,108,-2,-0.018181818,1.818181818,1
115,114,-1,-0.008695652,0.869565217,0
160,165,5,0.03125,3.125,0
130,130,0,0,0,1
235,240,5,0.021276596,2.127659574,0
-190,-200,-10,0.052631579,5.263157895,1
-245,-250,-5,0.020408163,2.040816327,1
165,155,-10,-0.060606061,6.060606061,1
-150,-147,3,-0.02,2,0
140,140,0,0,0,1
125,120,-5,-0.04,4,0
-110,-107,3,-0.027272727,2.727272727,1
-135,-160,-25,0.185185185,18.51851852,0
166,156,-10,-0.060240964,6.024096386,0
110,103,-7,-0.063636364,6.363636364,0
-150,-155,-5,0.033333333,3.333333333,1
-120,-130,-10,0.083333333,8.333333333,1
-145,-145,0,0,0,1
-160,-165,-5,0.03125,3.125,1
165,159,-6,-0.036363636,3.636363636,0
-145,-154,-9,0.062068966,6.206896552,0
-140,-158,-18,0.128571429,12.85714286,1
-150,-150,0,0,0,1
-320,-350,-30,0.09375,9.375,0
100,-105,-205,-2.05,5,1
135,124,-11,-0.081481481,8.148148148,0
140,147,7,0.05,5,1
-200,-245,-45,0.225,22.5,1
-160,-155,5,-0.03125,3.125,1
-170,-172,-2,0.011764706,1.176470588,1
-150,-150,0,0,0,1
135,141,6,0.044444444,4.444444444,0
-185,-220,-35,0.189189189,18.91891892,1
-180,-220,-40,0.222222222,22.22222222,1
120,118,-2,-0.016666667,1.666666667,0
275,260,-15,-0.054545455,5.454545455,1
-185,-190,-5,0.027027027,2.702702703,0
100,-109,-209,-2.09,9,1
-190,-210,-20,0.105263158,10.52631579,1
-145,-150,-5,0.034482759,3.448275862,1
-160,-160,0,0,0,1
-195,-220,-25,0.128205128,12.82051282,0
-160,-186,-26,0.1625,16.25,1
-150,-148,2,-0.013333333,1.333333333,1
105,106,1,0.00952381,0.952380952,1
-185,-245,-60,0.324324324,32.43243243,0
145,134,-11,-0.075862069,7.586206897,0
125,110,-15,-0.12,12,0
260,250,-10,-0.038461538,3.846153846,1
170,175,5,0.029411765,2.941176471,0
-110,-123,-13,0.118181818,11.81818182,0
160,165,5,0.03125,3.125,1
155,129,-26,-0.167741935,16.77419355,1
-140,-139,1,-0.007142857,0.714285714,1
-235,-240,-5,0.021276596,2.127659574,1
100,-125,-225,-2.25,25,1
-170,-163,7,-0.041176471,4.117647059,0
120,120,0,0,0,1
-130,-147,-17,0.130769231,13.07692308,0
175,170,-5,-0.028571429,2.857142857,1
-250,-240,10,-0.04,4,1
-140,-143,-3,0.021428571,2.142857143,1
-170,-180,-10,0.058823529,5.882352941,0
-170,-170,0,0,0,1
105,106,1,0.00952381,0.952380952,0
140,106,-34,-0.242857143,24.28571429,0
100,-118,-218,-2.18,18,1
135,136,1,0.007407407,0.740740741,0
140,-102,-242,-1.728571429,30,0
-105,-101,4,-0.038095238,3.80952381,0
-135,-146,-11,0.081481481,8.148148148,1
-115,-119,-4,0.034782609,3.47826087,1
155,148,-7,-0.04516129,4.516129032,0
140,134,-6,-0.042857143,4.285714286,0
-110,-106,4,-0.036363636,3.636363636,1
155,162,7,0.04516129,4.516129032,0
105,-112,-217,-2.066666667,16.19047619,1
-105,-116,-11,0.104761905,10.47619048,1
-160,-153,7,-0.04375,4.375,0
145,140,-5,-0.034482759,3.448275862,0
115,115,0,0,0,0
110,108,-2,-0.018181818,1.818181818,1
-180,-232,-52,0.288888889,28.88888889,1
-115,-111,4,-0.034782609,3.47826087,1
150,143,-7,-0.046666667,4.666666667,0
-115,-120,-5,0.043478261,4.347826087,1
125,106,-19,-0.152,15.2,0
120,-104,-224,-1.866666667,20,1
145,128,-17,-0.117241379,11.72413793,0
-120,-139,-19,0.158333333,15.83333333,1
-195,-200,-5,0.025641026,2.564102564,1
-135,-157,-22,0.162962963,16.2962963,0
160,135,-25,-0.15625,15.625,1
130,125,-5,-0.038461538,3.846153846,0
165,168,3,0.018181818,1.818181818,1
-130,-130,0,0,0,1
105,105,0,0,0,0
155,160,5,0.032258065,3.225806452,0
-145,-153,-8,0.055172414,5.517241379,1
-160,-190,-30,0.1875,18.75,1
-160,-168,-8,0.05,5,0
150,130,-20,-0.133333333,13.33333333,0
-180,-175,5,-0.027777778,2.777777778,0
-135,-135,0,0,0,1
-110,-112,-2,0.018181818,1.818181818,0
-220,-240,-20,0.090909091,9.090909091,1
-140,-138,2,-0.014285714,1.428571429,1
130,133,3,0.023076923,2.307692308,0
160,160,0,0,0,1
-190,-210,-20,0.105263158,10.52631579,0
145,112,-33,-0.227586207,22.75862069,1
-180,-190,-10,0.055555556,5.555555556,0
150,115,-35,-0.233333333,23.33333333,1
-140,-150,-10,0.071428571,7.142857143,0
-225,-250,-25,0.111111111,11.11111111,0
-115,-125,-10,0.086956522,8.695652174,0
170,176,6,0.035294118,3.529411765,0
-150,-160,-10,0.066666667,6.666666667,0
-105,-124,-19,0.180952381,18.0952381,1
-120,-130,-10,0.083333333,8.333333333,0
-180,-184,-4,0.022222222,2.222222222,0
-125,-134,-9,0.072,7.2,0
-130,-136,-6,0.046153846,4.615384615,1
-125,-126,-1,0.008,0.8,1
-135,-130,5,-0.037037037,3.703703704,0
160,152,-8,-0.05,5,0
165,170,5,0.03030303,3.03030303,1
-170,-167,3,-0.017647059,1.764705882,1
-115,-118,-3,0.026086957,2.608695652,1
-160,-156,4,-0.025,2.5,1
-110,-113,-3,0.027272727,2.727272727,0
-145,-163,-18,0.124137931,12.4137931,1
140,143,3,0.021428571,2.142857143,1
140,141,1,0.007142857,0.714285714,0
145,150,5,0.034482759,3.448275862,1
-140,-138,2,-0.014285714,1.428571429,0
100,-106,-206,-2.06,6,0
155,158,3,0.019354839,1.935483871,0
-180,-170,10,-0.055555556,5.555555556,0
155,140,-15,-0.096774194,9.677419355,0
105,-112,-217,-2.066666667,16.19047619,0
130,132,2,0.015384615,1.538461538,1
-115,-129,-14,0.12173913,12.17391304,0
190,169,-21,-0.110526316,11.05263158,0
-145,-154,-9,0.062068966,6.206896552,1
110,-118,-228,-2.072727273,25.45454545,0
125,116,-9,-0.072,7.2,0
-200,-200,0,0,0,1
-180,-170,10,-0.055555556,5.555555556,1
105,107,2,0.019047619,1.904761905,1
140,146,6,0.042857143,4.285714286,0
105,105,0,0,0,1
-105,-104,1,-0.00952381,0.952380952,1
-115,-111,4,-0.034782609,3.47826087,1
-140,-148,-8,0.057142857,5.714285714,1
-165,-172,-7,0.042424242,4.242424242,0
120,124,4,0.033333333,3.333333333,1
130,127,-3,-0.023076923,2.307692308,0
120,124,4,0.033333333,3.333333333,0
150,138,-12,-0.08,8,0
-145,-152,-7,0.048275862,4.827586207,1
-195,-200,-5,0.025641026,2.564102564,1
-110,-117,-7,0.063636364,6.363636364,0
145,133,-12,-0.082758621,8.275862069,0
-225,-270,-45,0.2,20,0
195,176,-19,-0.097435897,9.743589744,0
125,122,-3,-0.024,2.4,0
115,112,-3,-0.026086957,2.608695652,0
-140,-140,0,0,0,1
115,116,1,0.008695652,0.869565217,1
120,122,2,0.016666667,1.666666667,1
-190,-230,-40,0.210526316,21.05263158,1
120,108,-12,-0.1,10,1
115,118,3,0.026086957,2.608695652,0
165,170,5,0.03030303,3.03030303,0
165,170,5,0.03030303,3.03030303,1
100,-110,-210,-2.1,10,0
100,101,1,0.01,1,1
-200,-205,-5,0.025,2.5,0
-275,-296,-21,0.076363636,7.636363636,1
-170,-208,-38,0.223529412,22.35294118,0
100,102,2,0.02,2,0
-170,-180,-10,0.058823529,5.882352941,1
125,116,-9,-0.072,7.2,0
175,180,5,0.028571429,2.857142857,0
-120,-127,-7,0.058333333,5.833333333,1
-110,-106,4,-0.036363636,3.636363636,1
-105,-107,-2,0.019047619,1.904761905,1
-130,-155,-25,0.192307692,19.23076923,0
-180,-219,-39,0.216666667,21.66666667,1
-105,-128,-23,0.219047619,21.9047619,1
-190,-220,-30,0.157894737,15.78947368,0
-145,-169,-24,0.165517241,16.55172414,0
180,175,-5,-0.027777778,2.777777778,0
-235,-300,-65,0.276595745,27.65957447,1
-180,-186,-6,0.033333333,3.333333333,0
-170,-172,-2,0.011764706,1.176470588,1
-115,-119,-4,0.034782609,3.47826087,1
-225,-220,5,-0.022222222,2.222222222,1
135,120,-15,-0.111111111,11.11111111,0
130,125,-5,-0.038461538,3.846153846,0
-105,-109,-4,0.038095238,3.80952381,0
-125,-200,-75,0.6,60,0
-125,-128,-3,0.024,2.4,0
-165,-158,7,-0.042424242,4.242424242,0
-140,-148,-8,0.057142857,5.714285714,1
-110,-127,-17,0.154545455,15.45454545,0
-145,-162,-17,0.117241379,11.72413793,0
140,-112,-252,-1.8,37.14285714,0
-210,-247,-37,0.176190476,17.61904762,1
-150,-152,-2,0.013333333,1.333333333,1
-105,-111,-6,0.057142857,5.714285714,1
-235,-270,-35,0.14893617,14.89361702,1
135,139,4,0.02962963,2.962962963,0
125,114,-11,-0.088,8.8,0
145,133,-12,-0.082758621,8.275862069,1
180,173,-7,-0.038888889,3.888888889,0
115,116,1,0.008695652,0.869565217,1
-120,-121,-1,0.008333333,0.833333333,0
-125,-130,-5,0.04,4,1
150,153,3,0.02,2,1
-115,-136,-21,0.182608696,18.26086957,1
100,100,0,0,0,1
-120,-121,-1,0.008333333,0.833333333,1
220,210,-10,-0.045454545,4.545454545,0
-170,-168,2,-0.011764706,1.176470588,0
-160,-155,5,-0.03125,3.125,0
-105,-101,4,-0.038095238,3.80952381,0
135,121,-14,-0.103703704,10.37037037,0
-125,-130,-5,0.04,4,1
-115,-115,0,0,0,1
-125,-124,1,-0.008,0.8,0
150,157,7,0.046666667,4.666666667,1
134,126,-8,-0.059701493,5.970149254,0
-105,-106,-1,0.00952381,0.952380952,1
-225,-230,-5,0.022222222,2.222222222,1
115,107,-8,-0.069565217,6.956521739,0
110,104,-6,-0.054545455,5.454545455,1
163,140,-23,-0.141104294,14.11042945,1
-105,-106,-1,0.00952381,0.952380952,0
-125,-126,-1,0.008,0.8,0
-105,-138,-33,0.314285714,31.42857143,1
-130,-147,-17,0.130769231,13.07692308,0
-123,-134,-11,0.089430894,8.943089431,0
-163,-170,-7,0.042944785,4.294478528,0
-109,-118,-9,0.082568807,8.256880734,1
-105,-109,-4,0.038095238,3.80952381,0
212,207,-5,-0.023584906,2.358490566,0
-177,-206,-29,0.163841808,16.38418079,1
-120,-132,-12,0.1,10,1
124,-101,-225,-1.814516129,20.16129032,1
105,-111,-216,-2.057142857,15.23809524,0
118,108,-10,-0.084745763,8.474576271,0
-105,-124,-19,0.180952381,18.0952381,0
-195,-220,-25,0.128205128,12.82051282,0
115,115,0,0,0,1
-215,-277,-62,0.288372093,28.8372093,0
100,-106,-206,-2.06,6,0
200,194,-6,-0.03,3,0
120,106,-14,-0.116666667,11.66666667,1
105,-122,-227,-2.161904762,25.71428571,1
105,-105,-210,-2,9.523809524,1
135,137,2,0.014814815,1.481481481,0
-165,-166,-1,0.006060606,0.606060606,0
100,-101,-201,-2.01,1,1
-105,-107,-2,0.019047619,1.904761905,0
125,127,2,0.016,1.6,0
-145,-150,-5,0.034482759,3.448275862,1
-195,-200,-5,0.025641026,2.564102564,1
-110,-115,-5,0.045454545,4.545454545,1
-185,-205,-20,0.108108108,10.81081081,1
150,126,-24,-0.16,16,0
-120,-128,-8,0.066666667,6.666666667,0
145,145,0,0,0,1
-170,-180,-10,0.058823529,5.882352941,0
115,108,-7,-0.060869565,6.086956522,0
-125,-133,-8,0.064,6.4,1
120,118,-2,-0.016666667,1.666666667,0
-120,-154,-34,0.283333333,28.33333333,0
-110,-131,-21,0.190909091,19.09090909,1
155,149,-6,-0.038709677,3.870967742,1
-235,-230,5,-0.021276596,2.127659574,1
105,106,1,0.00952381,0.952380952,0
205,214,9,0.043902439,4.390243902,1
-130,-154,-24,0.184615385,18.46153846,0
-170,-176,-6,0.035294118,3.529411765,0
-140,-138,2,-0.014285714,1.428571429,1
-110,-108,2,-0.018181818,1.818181818,0
-105,-123,-18,0.171428571,17.14285714,0
-115,-200,-85,0.739130435,73.91304348,0
-135,-140,-5,0.037037037,3.703703704,1
-150,-151,-1,0.006666667,0.666666667,1
-130,-132,-2,0.015384615,1.538461538,1
-170,-188,-18,0.105882353,10.58823529,0
-120,-138,-18,0.15,15,1
-130,-131,-1,0.007692308,0.769230769,1
-125,-148,-23,0.184,18.4,1
120,113,-7,-0.058333333,5.833333333,1
-135,-138,-3,0.022222222,2.222222222,1
130,115,-15,-0.115384615,11.53846154,0
-130,-152,-22,0.169230769,16.92307692,1
140,128,-12,-0.085714286,8.571428571,0
-160,-156,4,-0.025,2.5,1
-185,-185,0,0,0,0
-270,-270,0,0,0,0
-110,-109,1,-0.009090909,0.909090909,1
-120,-125,-5,0.041666667,4.166666667,1
-110,-105,5,-0.045454545,4.545454545,0
200,186,-14,-0.07,7,0
105,104,-1,-0.00952381,0.952380952,0
-115,-120,-5,0.043478261,4.347826087,0
-130,-127,3,-0.023076923,2.307692308,0
105,-103,-208,-1.980952381,7.619047619,0
-120,-131,-11,0.091666667,9.166666667,1
-145,-168,-23,0.15862069,15.86206897,0
-115,-122,-7,0.060869565,6.086956522,0
-140,-152,-12,0.085714286,8.571428571,0
160,163,3,0.01875,1.875,0
-260,-264,-4,0.015384615,1.538461538,0
210,181,-29,-0.138095238,13.80952381,0
-160,-167,-7,0.04375,4.375,0
-200,-210,-10,0.05,5,1
135,140,5,0.037037037,3.703703704,0
-130,-126,4,-0.030769231,3.076923077,0
-115,-136,-21,0.182608696,18.26086957,1
120,103,-17,-0.141666667,14.16666667,1
160,121,-39,-0.24375,24.375,1
-120,-126,-6,0.05,5,1
-120,-116,4,-0.033333333,3.333333333,1
145,152,7,0.048275862,4.827586207,0
-180,-210,-30,0.166666667,16.66666667,0
155,150,-5,-0.032258065,3.225806452,1
-185,-180,5,-0.027027027,2.702702703,1
-180,-188,-8,0.044444444,4.444444444,1
160,157,-3,-0.01875,1.875,0
-130,-137,-7,0.053846154,5.384615385,1
-160,-168,-8,0.05,5,0
-115,-120,-5,0.043478261,4.347826087,0
-110,-106,4,-0.036363636,3.636363636,1
-235,-260,-25,0.106382979,10.63829787,1
-125,-131,-6,0.048,4.8,0
110,-114,-224,-2.036363636,21.81818182,0
-110,-115,-5,0.045454545,4.545454545,0
-130,-154,-24,0.184615385,18.46153846,0
135,135,0,0,0,1
-120,-124,-4,0.033333333,3.333333333,1
-130,-132,-2,0.015384615,1.538461538,1
-140,-167,-27,0.192857143,19.28571429,1
-125,-132,-7,0.056,5.6,1
105,109,4,0.038095238,3.80952381,1
155,161,6,0.038709677,3.870967742,0
-170,-165,5,-0.029411765,2.941176471,0
135,140,5,0.037037037,3.703703704,0
-140,-140,0,0,0,1
-120,-122,-2,0.016666667,1.666666667,0
125,130,5,0.04,4,0
-160,-160,0,0,0,0
120,107,-13,-0.108333333,10.83333333,1
140,126,-14,-0.1,10,1
190,170,-20,-0.105263158,10.52631579,1
-140,-145,-5,0.035714286,3.571428571,1
-130,-158,-28,0.215384615,21.53846154,1
-130,-127,3,-0.023076923,2.307692308,1
-105,-117,-12,0.114285714,11.42857143,1
130,126,-4,-0.030769231,3.076923077,0
-135,-134,1,-0.007407407,0.740740741,0
-135,-152,-17,0.125925926,12.59259259,1
135,134,-1,-0.007407407,0.740740741,0
110,109,-1,-0.009090909,0.909090909,0
-115,-110,5,-0.043478261,4.347826087,1
115,119,4,0.034782609,3.47826087,0
130,128,-2,-0.015384615,1.538461538,1
115,100,-15,-0.130434783,13.04347826,0
125,124,-1,-0.008,0.8,1
155,160,5,0.032258065,3.225806452,1
-105,-111,-6,0.057142857,5.714285714,0
130,117,-13,-0.1,10,1
-120,-129,-9,0.075,7.5,1
-115,-117,-2,0.017391304,1.739130435,0
-210,-213,-3,0.014285714,1.428571429,1
-140,-150,-10,0.071428571,7.142857143,1
120,120,0,0,0,0
120,118,-2,-0.016666667,1.666666667,1
-120,-130,-10,0.083333333,8.333333333,1
115,111,-4,-0.034782609,3.47826087,1
-190,-190,0,0,0,1
-270,-266,4,-0.014814815,1.481481481,1
125,112,-13,-0.104,10.4,1
155,160,5,0.032258065,3.225806452,1
135,140,5,0.037037037,3.703703704,0
-115,-117,-2,0.017391304,1.739130435,0
-140,-149,-9,0.064285714,6.428571429,1
-150,-152,-2,0.013333333,1.333333333,0
-145,-142,3,-0.020689655,2.068965517,1
115,120,5,0.043478261,4.347826087,1
105,-131,-236,-2.247619048,34.28571429,1
-115,-135,-20,0.173913043,17.39130435,0
-135,-140,-5,0.037037037,3.703703704,1
-180,-194,-14,0.077777778,7.777777778,0
-190,-190,0,0,0,0
-200,-230,-30,0.15,15,1
-140,-148,-8,0.057142857,5.714285714,0
-140,-139,1,-0.007142857,0.714285714,1
-150,-154,-4,0.026666667,2.666666667,1
-210,-224,-14,0.066666667,6.666666667,1
110,105,-5,-0.045454545,4.545454545,0
-160,-160,0,0,0,1
115,-149,-264,-2.295652174,55.65217391,1
-110,-123,-13,0.118181818,11.81818182,0
-120,-117,3,-0.025,2.5,0
-160,-182,-22,0.1375,13.75,0
-125,-121,4,-0.032,3.2,1
135,129,-6,-0.044444444,4.444444444,1
-170,-169,1,-0.005882353,0.588235294,1
170,172,2,0.011764706,1.176470588,1
-210,-240,-30,0.142857143,14.28571429,1
-120,-145,-25,0.208333333,20.83333333,0
-105,-113,-8,0.076190476,7.619047619,1
-105,-110,-5,0.047619048,4.761904762,0
150,123,-27,-0.18,18,1
155,143,-12,-0.077419355,7.741935484,1
105,-114,-219,-2.085714286,18.0952381,1
170,122,-48,-0.282352941,28.23529412,0
125,116,-9,-0.072,7.2,1
105,102,-3,-0.028571429,2.857142857,0
135,142,7,0.051851852,5.185185185,0
-165,-185,-20,0.121212121,12.12121212,0
-140,-162,-22,0.157142857,15.71428571,0
145,142,-3,-0.020689655,2.068965517,0
-235,-246,-11,0.046808511,4.680851064,1
225,220,-5,-0.022222222,2.222222222,0
-140,-144,-4,0.028571429,2.857142857,1
-165,-166,-1,0.006060606,0.606060606,1
-140,-142,-2,0.014285714,1.428571429,0
110,105,-5,-0.045454545,4.545454545,1
-130,-156,-26,0.2,20,1
-160,-159,1,-0.00625,0.625,1
-140,-156,-16,0.114285714,11.42857143,1
-120,-118,2,-0.016666667,1.666666667,1
-115,-117,-2,0.017391304,1.739130435,1
-150,-160,-10,0.066666667,6.666666667,0
-210,-205,5,-0.023809524,2.380952381,1
-170,-205,-35,0.205882353,20.58823529,1
230,220,-10,-0.043478261,4.347826087,1
-250,-290,-40,0.16,16,0
-170,-190,-20,0.117647059,11.76470588,0
-110,-108,2,-0.018181818,1.818181818,1
-170,-168,2,-0.011764706,1.176470588,1
-170,-185,-15,0.088235294,8.823529412,0
-220,-230,-10,0.045454545,4.545454545,0
-130,-128,2,-0.015384615,1.538461538,1
130,128,-2,-0.015384615,1.538461538,0
-165,-174,-9,0.054545455,5.454545455,0
250,220,-30,-0.12,12,0
175,180,5,0.028571429,2.857142857,0
145,143,-2,-0.013793103,1.379310345,1
-140,-141,-1,0.007142857,0.714285714,0
-110,-128,-18,0.163636364,16.36363636,1
-195,-250,-55,0.282051282,28.20512821,1
-140,-135,5,-0.035714286,3.571428571,0
-140,-163,-23,0.164285714,16.42857143,0
-160,-176,-16,0.1,10,0
235,225,-10,-0.042553191,4.255319149,0
-115,-114,1,-0.008695652,0.869565217,0
135,139,4,0.02962963,2.962962963,0
-105,-102,3,-0.028571429,2.857142857,0
-170,-172,-2,0.011764706,1.176470588,0
-185,-178,7,-0.037837838,3.783783784,1
145,144,-1,-0.006896552,0.689655172,0
230,224,-6,-0.026086957,2.608695652,0
180,185,5,0.027777778,2.777777778,0
140,135,-5,-0.035714286,3.571428571,0
-165,-172,-7,0.042424242,4.242424242,1
-260,-260,0,0,0,0
-200,-240,-40,0.2,20,1
-110,-120,-10,0.090909091,9.090909091,1
-210,-230,-20,0.095238095,9.523809524,1
135,119,-16,-0.118518519,11.85185185,1
135,141,6,0.044444444,4.444444444,0
150,147,-3,-0.02,2,0
140,136,-4,-0.028571429,2.857142857,0
-235,-246,-11,0.046808511,4.680851064,1
-105,-119,-14,0.133333333,13.33333333,1
-125,-124,1,-0.008,0.8,0
100,-103,-203,-2.03,3,0
195,178,-17,-0.087179487,8.717948718,0
175,180,5,0.028571429,2.857142857,0
180,173,-7,-0.038888889,3.888888889,1
225,210,-15,-0.066666667,6.666666667,1
-115,-112,3,-0.026086957,2.608695652,1
190,170,-20,-0.105263158,10.52631579,0
170,176,6,0.035294118,3.529411765,0
145,133,-12,-0.082758621,8.275862069,0
-150,-159,-9,0.06,6,1
-220,-210,10,-0.045454545,4.545454545,0
130,133,3,0.023076923,2.307692308,0
-170,-168,2,-0.011764706,1.176470588,1
-145,-143,2,-0.013793103,1.379310345,1
135,124,-11,-0.081481481,8.148148148,0
205,178,-27,-0.131707317,13.17073171,1
-225,-300,-75,0.333333333,33.33333333,1
-150,-200,-50,0.333333333,33.33333333,1
-165,-182,-17,0.103030303,10.3030303,1
-195,-212,-17,0.087179487,8.717948718,0
-105,-112,-7,0.066666667,6.666666667,1
-180,-186,-6,0.033333333,3.333333333,0
175,175,0,0,0,0
-220,-260,-40,0.181818182,18.18181818,0
-150,-158,-8,0.053333333,5.333333333,1
-275,-300,-25,0.090909091,9.090909091,1
-190,-198,-8,0.042105263,4.210526316,1
-170,-185,-15,0.088235294,8.823529412,1
210,210,0,0,0,0
-210,-230,-20,0.095238095,9.523809524,1
-160,-159,1,-0.00625,0.625,0
-130,-143,-13,0.1,10,0
-195,-230,-35,0.179487179,17.94871795,1
180,176,-4,-0.022222222,2.222222222,0
155,141,-14,-0.090322581,9.032258065,0
-250,-360,-110,0.44,36,1
-170,-180,-10,0.058823529,5.882352941,1
-255,-260,-5,0.019607843,1.960784314,1
-220,-210,10,-0.045454545,4.545454545,1
115,-102,-217,-1.886956522,14.7826087,1
165,153,-12,-0.072727273,7.272727273,0
185,190,5,0.027027027,2.702702703,0
165,163,-2,-0.012121212,1.212121212,0
145,126,-19,-0.131034483,13.10344828,1
180,165,-15,-0.083333333,8.333333333,0
150,144,-6,-0.04,4,0
175,164,-11,-0.062857143,6.285714286,1
225,230,5,0.022222222,2.222222222,0
135,120,-15,-0.111111111,11.11111111,1
-315,-350,-35,0.111111111,11.11111111,1
160,162,2,0.0125,1.25,0
-250,-250,0,0,0,1
-200,-208,-8,0.04,4,1
150,155,5,0.033333333,3.333333333,0
-170,-174,-4,0.023529412,2.352941176,0
-135,-131,4,-0.02962963,2.962962963,1
135,135,0,0,0,0
-110,-120,-10,0.090909091,9.090909091,1
-140,-148,-8,0.057142857,5.714285714,1
-220,-220,0,0,0,1
-195,-240,-45,0.230769231,23.07692308,1
-170,-163,7,-0.041176471,4.117647059,0
-115,-125,-10,0.086956522,8.695652174,1
115,112,-3,-0.026086957,2.608695652,1
140,132,-8,-0.057142857,5.714285714,0
-150,-150,0,0,0,0
135,137,2,0.014814815,1.481481481,1
-145,-170,-25,0.172413793,17.24137931,1
-200,-210,-10,0.05,5,0
-180,-182,-2,0.011111111,1.111111111,1
185,173,-12,-0.064864865,6.486486486,0
160,145,-15,-0.09375,9.375,1
-170,-163,7,-0.041176471,4.117647059,1
-135,-152,-17,0.125925926,12.59259259,1
-110,-122,-12,0.109090909,10.90909091,1
220,230,10,0.045454545,4.545454545,0
-270,-269,1,-0.003703704,0.37037037,1
150,135,-15,-0.1,10,1
-125,-134,-9,0.072,7.2,1
-110,-110,0,0,0,1
-130,-147,-17,0.130769231,13.07692308,1
100,103,3,0.03,3,0
-180,-182,-2,0.011111111,1.111111111,1
-200,-200,0,0,0,1
-260,-250,10,-0.038461538,3.846153846,1
-130,-129,1,-0.007692308,0.769230769,1
120,120,0,0,0,1
190,195,5,0.026315789,2.631578947,0
-140,-156,-16,0.114285714,11.42857143,0
-210,-240,-30,0.142857143,14.28571429,0
-165,-190,-25,0.151515152,15.15151515,1
-170,-168,2,-0.011764706,1.176470588,1
-135,-144,-9,0.066666667,6.666666667,0
-200,-215,-15,0.075,7.5,1
115,108,-7,-0.060869565,6.086956522,1
-160,-174,-14,0.0875,8.75,1
-135,-133,2,-0.014814815,1.481481481,0
-210,-220,-10,0.047619048,4.761904762,1
155,146,-9,-0.058064516,5.806451613,0
145,149,4,0.027586207,2.75862069,1
-170,-164,6,-0.035294118,3.529411765,1
105,104,-1,-0.00952381,0.952380952,0
-150,-164,-14,0.093333333,9.333333333,1
-180,-174,6,-0.033333333,3.333333333,0
-220,-218,2,-0.009090909,0.909090909,1
100,105,5,0.05,5,0
210,215,5,0.023809524,2.380952381,0
150,147,-3,-0.02,2,1
-170,-164,6,-0.035294118,3.529411765,1
135,126,-9,-0.066666667,6.666666667,0
150,148,-2,-0.013333333,1.333333333,1
-135,-137,-2,0.014814815,1.481481481,1
130,116,-14,-0.107692308,10.76923077,1
155,154,-1,-0.006451613,0.64516129,0
150,145,-5,-0.033333333,3.333333333,0
-180,-189,-9,0.05,5,1
190,195,5,0.026315789,2.631578947,1
-220,-210,10,-0.045454545,4.545454545,0
-280,-320,-40,0.142857143,14.28571429,1
-130,-127,3,-0.023076923,2.307692308,1
-190,-220,-30,0.157894737,15.78947368,1
-110,-105,5,-0.045454545,4.545454545,0
-140,-135,5,-0.035714286,3.571428571,0
-160,-201,-41,0.25625,25.625,1
145,128,-17,-0.117241379,11.72413793,1
100,-115,-215,-2.15,15,0
190,177,-13,-0.068421053,6.842105263,1
170,176,6,0.035294118,3.529411765,0
-140,-135,5,-0.035714286,3.571428571,0
145,137,-8,-0.055172414,5.517241379,0
-200,-196,4,-0.02,2,1
135,133,-2,-0.014814815,1.481481481,0
175,171,-4,-0.022857143,2.285714286,0
-170,-165,5,-0.029411765,2.941176471,1
-185,-184,1,-0.005405405,0.540540541,1
-290,-290,0,0,0,1
-125,-133,-8,0.064,6.4,1
150,141,-9,-0.06,6,1
-170,-176,-6,0.035294118,3.529411765,0
-210,-225,-15,0.071428571,7.142857143,0
180,169,-11,-0.061111111,6.111111111,1
110,-103,-213,-1.936363636,11.81818182,0
-115,-115,0,0,0,1
-145,-155,-10,0.068965517,6.896551724,1
200,181,-19,-0.095,9.5,0
120,115,-5,-0.041666667,4.166666667,1
-185,-223,-38,0.205405405,20.54054054,1
240,230,-10,-0.041666667,4.166666667,0
-250,-274,-24,0.096,9.6,1
-265,-255,10,-0.037735849,3.773584906,1
145,140,-5,-0.034482759,3.448275862,1
115,113,-2,-0.017391304,1.739130435,0
-115,-118,-3,0.026086957,2.608695652,0
-145,-180,-35,0.24137931,24.13793103,0
-110,-135,-25,0.227272727,22.72727273,1
-140,-158,-18,0.128571429,12.85714286,1
105,-110,-215,-2.047619048,14.28571429,0
-130,-146,-16,0.123076923,12.30769231,0
135,137,2,0.014814815,1.481481481,0
-305,-320,-15,0.049180328,4.918032787,1
115,102,-13,-0.113043478,11.30434783,0
-105,-107,-2,0.019047619,1.904761905,0
-125,-140,-15,0.12,12,0
-190,-250,-60,0.315789474,31.57894737,1
135,120,-15,-0.111111111,11.11111111,0
100,100,0,0,0,1
-140,-170,-30,0.214285714,21.42857143,0
165,160,-5,-0.03030303,3.03030303,1
-185,-196,-11,0.059459459,5.945945946,0
305,280,-25,-0.081967213,8.196721311,1
100,-147,-247,-2.47,47,0
150,128,-22,-0.146666667,14.66666667,1
-200,-220,-20,0.1,10,1
-115,-121,-6,0.052173913,5.217391304,1
-165,-169,-4,0.024242424,2.424242424,0
-310,-302,8,-0.025806452,2.580645161,1
-110,-112,-2,0.018181818,1.818181818,1
-110,-114,-4,0.036363636,3.636363636,1
270,280,10,0.037037037,3.703703704,0
135,115,-20,-0.148148148,14.81481481,0
145,146,1,0.006896552,0.689655172,0
-185,-198,-13,0.07027027,7.027027027,1
170,162,-8,-0.047058824,4.705882353,1
155,150,-5,-0.032258065,3.225806452,1
-185,-196,-11,0.059459459,5.945945946,0
-225,-290,-65,0.288888889,28.88888889,1
-190,-190,0,0,0,0
-165,-196,-31,0.187878788,18.78787879,1
105,-101,-206,-1.961904762,5.714285714,0
305,310,5,0.016393443,1.639344262,0
145,124,-21,-0.144827586,14.48275862,0
-140,-150,-10,0.071428571,7.142857143,0
160,155,-5,-0.03125,3.125,0
225,210,-15,-0.066666667,6.666666667,0
180,168,-12,-0.066666667,6.666666667,0
190,173,-17,-0.089473684,8.947368421,1
-200,-210,-10,0.05,5,0
-170,-192,-22,0.129411765,12.94117647,1
-250,-240,10,-0.04,4,1
175,182,7,0.04,4,1
-225,-230,-5,0.022222222,2.222222222,1
-235,-264,-29,0.123404255,12.34042553,0
-115,-121,-6,0.052173913,5.217391304,1
270,260,-10,-0.037037037,3.703703704,0
-105,-102,3,-0.028571429,2.857142857,0
175,164,-11,-0.062857143,6.285714286,0
100,-108,-208,-2.08,8,0
-250,-242,8,-0.032,3.2,1
-105,-107,-2,0.019047619,1.904761905,0
230,230,0,0,0,0
-220,-230,-10,0.045454545,4.545454545,1
180,178,-2,-0.011111111,1.111111111,0
-195,-200,-5,0.025641026,2.564102564,0
145,136,-9,-0.062068966,6.206896552,0
165,141,-24,-0.145454545,14.54545455,0
-235,-240,-5,0.021276596,2.127659574,1
-140,-147,-7,0.05,5,1
225,215,-10,-0.044444444,4.444444444,0
125,118,-7,-0.056,5.6,0
155,132,-23,-0.148387097,14.83870968,0
-340,-340,0,0,0,0
-120,-126,-6,0.05,5,0
115,100,-15,-0.130434783,13.04347826,0
180,157,-23,-0.127777778,12.77777778,0
145,120,-25,-0.172413793,17.24137931,0
-225,-220,5,-0.022222222,2.222222222,1
-225,-240,-15,0.066666667,6.666666667,1
-185,-178,7,-0.037837838,3.783783784,0
-145,-153,-8,0.055172414,5.517241379,0
185,162,-23,-0.124324324,12.43243243,1
-225,-270,-45,0.2,20,0
110,110,0,0,0,0
-190,-196,-6,0.031578947,3.157894737,0
120,108,-12,-0.1,10,0
145,150,5,0.034482759,3.448275862,0
-115,-113,2,-0.017391304,1.739130435,0
-110,-114,-4,0.036363636,3.636363636,1
115,106,-9,-0.07826087,7.826086957,0
115,114,-1,-0.008695652,0.869565217,0
-105,-114,-9,0.085714286,8.571428571,1
-235,-250,-15,0.063829787,6.382978723,0
-115,-134,-19,0.165217391,16.52173913,0
-105,-105,0,0,0,1
270,250,-20,-0.074074074,7.407407407,0
-105,-114,-9,0.085714286,8.571428571,0
-120,-119,1,-0.008333333,0.833333333,0
100,-111,-211,-2.11,11,0
-165,-198,-33,0.2,20,1
140,129,-11,-0.078571429,7.857142857,0
-145,-152,-7,0.048275862,4.827586207,0
125,116,-9,-0.072,7.2,0
115,117,2,0.017391304,1.739130435,1
195,196,1,0.005128205,0.512820513,0
-160,-165,-5,0.03125,3.125,0
-255,-248,7,-0.02745098,2.745098039,1
-110,-113,-3,0.027272727,2.727272727,1
-135,-135,0,0,0,0
-180,-222,-42,0.233333333,23.33333333,0
-115,-113,2,-0.017391304,1.739130435,1
100,-105,-205,-2.05,5,1
-105,-107,-2,0.019047619,1.904761905,1
170,145,-25,-0.147058824,14.70588235,0
125,126,1,0.008,0.8,0
-235,-260,-25,0.106382979,10.63829787,1
200,187,-13,-0.065,6.5,1
110,109,-1,-0.009090909,0.909090909,0
170,143,-27,-0.158823529,15.88235294,1
-180,-194,-14,0.077777778,7.777777778,1
130,110,-20,-0.153846154,15.38461538,0
-135,-153,-18,0.133333333,13.33333333,0
120,124,4,0.033333333,3.333333333,1
-120,-142,-22,0.183333333,18.33333333,1
100,-110,-210,-2.1,10,1
-165,-159,6,-0.036363636,3.636363636,0
145,129,-16,-0.110344828,11.03448276,1
100,104,4,0.04,4,0
-115,-117,-2,0.017391304,1.739130435,1
130,129,-1,-0.007692308,0.769230769,0
135,-105,-240,-1.777777778,29.62962963,1
-110,-107,3,-0.027272727,2.727272727,1
155,142,-13,-0.083870968,8.387096774,0
260,224,-36,-0.138461538,13.84615385,0
110,106,-4,-0.036363636,3.636363636,0
-165,-164,1,-0.006060606,0.606060606,0
-225,-247,-22,0.097777778,9.777777778,1
-160,-164,-4,0.025,2.5,1
175,171,-4,-0.022857143,2.285714286,1
130,119,-11,-0.084615385,8.461538462,0
-120,-124,-4,0.033333333,3.333333333,1
-265,-263,2,-0.00754717,0.754716981,0
-225,-230,-5,0.022222222,2.222222222,1
155,156,1,0.006451613,0.64516129,0
-150,-160,-10,0.066666667,6.666666667,0
180,171,-9,-0.05,5,0
-145,-164,-19,0.131034483,13.10344828,1
-170,-174,-4,0.023529412,2.352941176,0
120,117,-3,-0.025,2.5,1
185,191,6,0.032432432,3.243243243,0
175,181,6,0.034285714,3.428571429,0
190,176,-14,-0.073684211,7.368421053,0
105,-105,-210,-2,9.523809524,1
-190,-185,5,-0.026315789,2.631578947,1
185,194,9,0.048648649,4.864864865,0
105,-102,-207,-1.971428571,6.666666667,1
220,211,-9,-0.040909091,4.090909091,0
135,126,-9,-0.066666667,6.666666667,0
110,-123,-233,-2.118181818,30,1
145,143,-2,-0.013793103,1.379310345,1
165,168,3,0.018181818,1.818181818,0
175,147,-28,-0.16,16,0
200,205,5,0.025,2.5,0
-305,-300,5,-0.016393443,1.639344262,0
130,132,2,0.015384615,1.538461538,1
110,115,5,0.045454545,4.545454545,1
155,162,7,0.04516129,4.516129032,0
145,140,-5,-0.034482759,3.448275862,1
-185,-186,-1,0.005405405,0.540540541,1
-185,-185,0,0,0,0
-125,-127,-2,0.016,1.6,1
240,210,-30,-0.125,12.5,1
-220,-240,-20,0.090909091,9.090909091,1
-150,-149,1,-0.006666667,0.666666667,0
-160,-168,-8,0.05,5,1
190,180,-10,-0.052631579,5.263157895,1
145,130,-15,-0.103448276,10.34482759,0
-145,-147,-2,0.013793103,1.379310345,0
-210,-250,-40,0.19047619,19.04761905,1
-140,-143,-3,0.021428571,2.142857143,1
-190,-205,-15,0.078947368,7.894736842,0
160,125,-35,-0.21875,21.875,0
-170,-170,0,0,0,1
120,124,4,0.033333333,3.333333333,0
-195,-200,-5,0.025641026,2.564102564,1
-120,-124,-4,0.033333333,3.333333333,1
-300,-340,-40,0.133333333,13.33333333,1
-130,-144,-14,0.107692308,10.76923077,1
-180,-190,-10,0.055555556,5.555555556,0
135,139,4,0.02962963,2.962962963,0
130,135,5,0.038461538,3.846153846,1
-105,-128,-23,0.219047619,21.9047619,0
165,161,-4,-0.024242424,2.424242424,0
145,144,-1,-0.006896552,0.689655172,0
-125,-124,1,-0.008,0.8,1
165,170,5,0.03030303,3.03030303,0
285,260,-25,-0.087719298,8.771929825,1
110,102,-8,-0.072727273,7.272727273,0
-150,-155,-5,0.033333333,3.333333333,1
-120,-116,4,-0.033333333,3.333333333,0
-125,-186,-61,0.488,48.8,0
140,144,4,0.028571429,2.857142857,1
125,118,-7,-0.056,5.6,1
-270,-340,-70,0.259259259,25.92592593,1
-145,-149,-4,0.027586207,2.75862069,0
195,180,-15,-0.076923077,7.692307692,1
-150,-178,-28,0.186666667,18.66666667,0
-200,-205,-5,0.025,2.5,1
-130,-132,-2,0.015384615,1.538461538,0
-265,-270,-5,0.018867925,1.886792453,1
220,210,-10,-0.045454545,4.545454545,0
-160,-172,-12,0.075,7.5,0
135,-114,-249,-1.844444444,36.2962963,0
-130,-125,5,-0.038461538,3.846153846,0
-130,-140,-10,0.076923077,7.692307692,1
-340,-350,-10,0.029411765,2.941176471,1
-145,-174,-29,0.2,20,0
120,112,-8,-0.066666667,6.666666667,1
-165,-164,1,-0.006060606,0.606060606,1
-160,-176,-16,0.1,10,1
145,143,-2,-0.013793103,1.379310345,0
135,120,-15,-0.111111111,11.11111111,0
135,137,2,0.014814815,1.481481481,0
-170,-200,-30,0.176470588,17.64705882,1
-160,-159,1,-0.00625,0.625,0
100,-112,-212,-2.12,12,0
145,140,-5,-0.034482759,3.448275862,0
-135,-144,-9,0.066666667,6.666666667,1
130,115,-15,-0.115384615,11.53846154,0
135,129,-6,-0.044444444,4.444444444,1
145,152,7,0.048275862,4.827586207,1
-135,-131,4,-0.02962963,2.962962963,0
110,109,-1,-0.009090909,0.909090909,1
-225,-230,-5,0.022222222,2.222222222,1
-135,-147,-12,0.088888889,8.888888889,1
-190,-188,2,-0.010526316,1.052631579,1
150,157,7,0.046666667,4.666666667,0
-110,-120,-10,0.090909091,9.090909091,0
180,164,-16,-0.088888889,8.888888889,0
155,161,6,0.038709677,3.870967742,1
100,-102,-202,-2.02,2,0
130,108,-22,-0.169230769,16.92307692,0
135,140,5,0.037037037,3.703703704,0
145,138,-7,-0.048275862,4.827586207,0
-150,-153,-3,0.02,2,0
105,108,3,0.028571429,2.857142857,1
130,109,-21,-0.161538462,16.15384615,0
105,100,-5,-0.047619048,4.761904762,1
145,151,6,0.04137931,4.137931034,0
-305,-350,-45,0.147540984,14.75409836,0
-160,-178,-18,0.1125,11.25,1
-200,-210,-10,0.05,5,1
-195,-190,5,-0.025641026,2.564102564,1
-150,-148,2,-0.013333333,1.333333333,1
145,135,-10,-0.068965517,6.896551724,0
175,173,-2,-0.011428571,1.142857143,0
-130,-127,3,-0.023076923,2.307692308,1
100,101,1,0.01,1,0
125,112,-13,-0.104,10.4,0
105,-104,-209,-1.99047619,8.571428571,1
195,190,-5,-0.025641026,2.564102564,0
130,130,0,0,0,0
-145,-200,-55,0.379310345,37.93103448,1
170,170,0,0,0,1
-300,-330,-30,0.1,10,0
-195,-210,-15,0.076923077,7.692307692,1
-210,-210,0,0,0,0
140,124,-16,-0.114285714,11.42857143,1
150,130,-20,-0.133333333,13.33333333,1
110,114,4,0.036363636,3.636363636,1
-220,-210,10,-0.045454545,4.545454545,0
125,110,-15,-0.12,12,0
100,-105,-205,-2.05,5,1
110,112,2,0.018181818,1.818181818,1
135,118,-17,-0.125925926,12.59259259,1
145,140,-5,-0.034482759,3.448275862,1
150,134,-16,-0.106666667,10.66666667,0
-195,-210,-15,0.076923077,7.692307692,1
-110,-110,0,0,0,1
-140,-138,2,-0.014285714,1.428571429,0
-145,-140,5,-0.034482759,3.448275862,0
-110,-120,-10,0.090909091,9.090909091,1
-220,-215,5,-0.022727273,2.272727273,1
135,122,-13,-0.096296296,9.62962963,1
-130,-130,0,0,0,0
-160,-174,-14,0.0875,8.75,1
-225,-260,-35,0.155555556,15.55555556,1
-110,-110,0,0,0,1
145,129,-16,-0.110344828,11.03448276,0
175,135,-40,-0.228571429,22.85714286,0
-170,-220,-50,0.294117647,29.41176471,1
130,118,-12,-0.092307692,9.230769231,1
-110,-120,-10,0.090909091,9.090909091,0
-195,-220,-25,0.128205128,12.82051282,0
-110,-112,-2,0.018181818,1.818181818,0
150,153,3,0.02,2,0
120,117,-3,-0.025,2.5,1
-110,-110,0,0,0,1
-140,-170,-30,0.214285714,21.42857143,0
320,270,-50,-0.15625,15.625,1
135,127,-8,-0.059259259,5.925925926,0
115,-105,-220,-1.913043478,17.39130435,1
180,180,0,0,0,1
125,100,-25,-0.2,20,1
145,150,5,0.034482759,3.448275862,0
-110,-127,-17,0.154545455,15.45454545,0
175,150,-25,-0.142857143,14.28571429,1
120,114,-6,-0.05,5,1
110,111,1,0.009090909,0.909090909,1
-120,-126,-6,0.05,5,0
-110,-109,1,-0.009090909,0.909090909,1
140,139,-1,-0.007142857,0.714285714,0
-160,-153,7,-0.04375,4.375,0
-115,-122,-7,0.060869565,6.086956522,0
-280,-270,10,-0.035714286,3.571428571,1
165,145,-20,-0.121212121,12.12121212,1
-165,-167,-2,0.012121212,1.212121212,0
160,162,2,0.0125,1.25,1
-220,-210,10,-0.045454545,4.545454545,1
-135,-145,-10,0.074074074,7.407407407,1
-140,-158,-18,0.128571429,12.85714286,1
110,106,-4,-0.036363636,3.636363636,1
100,101,1,0.01,1,1
-135,-143,-8,0.059259259,5.925925926,1
-115,-123,-8,0.069565217,6.956521739,1
-140,-150,-10,0.071428571,7.142857143,0
170,167,-3,-0.017647059,1.764705882,0
125,108,-17,-0.136,13.6,0
145,146,1,0.006896552,0.689655172,0
-290,-295,-5,0.017241379,1.724137931,0
145,144,-1,-0.006896552,0.689655172,1
-130,-129,1,-0.007692308,0.769230769,0
-190,-196,-6,0.031578947,3.157894737,1
135,141,6,0.044444444,4.444444444,0
155,160,5,0.032258065,3.225806452,0
140,124,-16,-0.114285714,11.42857143,0
-120,-116,4,-0.033333333,3.333333333,0
135,139,4,0.02962963,2.962962963,0
-195,-200,-5,0.025641026,2.564102564,1
-220,-215,5,-0.022727273,2.272727273,1
-135,-132,3,-0.022222222,2.222222222,0
110,103,-7,-0.063636364,6.363636364,1
-225,-245,-20,0.088888889,8.888888889,0
-200,-210,-10,0.05,5,1
-170,-192,-22,0.129411765,12.94117647,0
220,210,-10,-0.045454545,4.545454545,0
-150,-152,-2,0.013333333,1.333333333,1
-235,-240,-5,0.021276596,2.127659574,0
-170,-174,-4,0.023529412,2.352941176,0
-135,-138,-3,0.022222222,2.222222222,1
175,175,0,0,0,0
-170,-192,-22,0.129411765,12.94117647,1
115,101,-14,-0.12173913,12.17391304,0
155,160,5,0.032258065,3.225806452,1
-125,-122,3,-0.024,2.4,1
-260,-275,-15,0.057692308,5.769230769,0
-260,-280,-20,0.076923077,7.692307692,1
120,105,-15,-0.125,12.5,1
180,190,10,0.055555556,5.555555556,0
170,152,-18,-0.105882353,10.58823529,0
185,180,-5,-0.027027027,2.702702703,0
130,135,5,0.038461538,3.846153846,1
-165,-160,5,-0.03030303,3.03030303,1
145,152,7,0.048275862,4.827586207,1
-250,-290,-40,0.16,16,1
165,165,0,0,0,1
160,100,-60,-0.375,37.5,0
160,150,-10,-0.0625,6.25,1
-115,-115,0,0,0,1
110,-108,-218,-1.981818182,16.36363636,1
100,-103,-203,-2.03,3,1
100,-106,-206,-2.06,6,0
-280,-298,-18,0.064285714,6.428571429,1
170,156,-14,-0.082352941,8.235294118,0
135,120,-15,-0.111111111,11.11111111,0
160,164,4,0.025,2.5,0
115,110,-5,-0.043478261,4.347826087,1
145,144,-1,-0.006896552,0.689655172,1
175,173,-2,-0.011428571,1.142857143,1
-135,-144,-9,0.066666667,6.666666667,1
-160,-170,-10,0.0625,6.25,0
150,137,-13,-0.086666667,8.666666667,1
-165,-190,-25,0.151515152,15.15151515,1
-260,-250,10,-0.038461538,3.846153846,1
115,110,-5,-0.043478261,4.347826087,1
-310,-340,-30,0.096774194,9.677419355,1
-140,-140,0,0,0,0
-120,-126,-6,0.05,5,1
175,175,0,0,0,1
145,148,3,0.020689655,2.068965517,1
225,230,5,0.022222222,2.222222222,0
-140,-136,4,-0.028571429,2.857142857,1
-210,-210,0,0,0,0
-115,-120,-5,0.043478261,4.347826087,1
135,119,-16,-0.118518519,11.85185185,1
-195,-196,-1,0.005128205,0.512820513,1
-150,-168,-18,0.12,12,0
-210,-206,4,-0.019047619,1.904761905,0
-110,-108,2,-0.018181818,1.818181818,0
-355,-380,-25,0.070422535,7.042253521,1
-170,-174,-4,0.023529412,2.352941176,1
-125,-128,-3,0.024,2.4,1
155,149,-6,-0.038709677,3.870967742,0
100,102,2,0.02,2,1
180,169,-11,-0.061111111,6.111111111,0
195,200,5,0.025641026,2.564102564,1
130,121,-9,-0.069230769,6.923076923,0
-235,-240,-5,0.021276596,2.127659574,0
-150,-157,-7,0.046666667,4.666666667,1
-135,-180,-45,0.333333333,33.33333333,0
140,140,0,0,0,0
105,106,1,0.00952381,0.952380952,0
160,160,0,0,0,1
205,205,0,0,0,1
175,180,5,0.028571429,2.857142857,0
190,151,-39,-0.205263158,20.52631579,0
-115,-116,-1,0.008695652,0.869565217,1
-130,-127,3,-0.023076923,2.307692308,1
135,140,5,0.037037037,3.703703704,1
-170,-163,7,-0.041176471,4.117647059,0
190,200,10,0.052631579,5.263157895,0
125,105,-20,-0.16,16,0
-145,-159,-14,0.096551724,9.655172414,1
175,182,7,0.04,4,0
180,182,2,0.011111111,1.111111111,1
-190,-198,-8,0.042105263,4.210526316,1
285,274,-11,-0.038596491,3.859649123,0
-185,-179,6,-0.032432432,3.243243243,1
105,100,-5,-0.047619048,4.761904762,0
-120,-134,-14,0.116666667,11.66666667,1
190,196,6,0.031578947,3.157894737,0
-195,-205,-10,0.051282051,5.128205128,1
-125,-130,-5,0.04,4,0
115,119,4,0.034782609,3.47826087,1
105,-102,-207,-1.971428571,6.666666667,0
-290,-315,-25,0.086206897,8.620689655,1
-120,-118,2,-0.016666667,1.666666667,1
115,-104,-219,-1.904347826,16.52173913,0
-195,-190,5,-0.025641026,2.564102564,0
-270,-280,-10,0.037037037,3.703703704,1
150,152,2,0.013333333,1.333333333,0
165,164,-1,-0.006060606,0.606060606,1
-235,-224,11,-0.046808511,4.680851064,0
105,-110,-215,-2.047619048,14.28571429,1
115,104,-11,-0.095652174,9.565217391,0
-280,-280,0,0,0,0
105,-104,-209,-1.99047619,8.571428571,0
-185,-190,-5,0.027027027,2.702702703,1
190,185,-5,-0.026315789,2.631578947,0
-210,-220,-10,0.047619048,4.761904762,0
105,104,-1,-0.00952381,0.952380952,0
-120,-126,-6,0.05,5,0
-120,-128,-8,0.066666667,6.666666667,1
-310,-330,-20,0.064516129,6.451612903,0
190,190,0,0,0,0
-245,-270,-25,0.102040816,10.20408163,0
-330,-330,0,0,0,1
110,108,-2,-0.018181818,1.818181818,0
200,180,-20,-0.1,10,0
-110,-128,-18,0.163636364,16.36363636,1
215,175,-40,-0.186046512,18.60465116,0
160,148,-12,-0.075,7.5,0
-105,-105,0,0,0,1
165,167,2,0.012121212,1.212121212,1
-180,-186,-6,0.033333333,3.333333333,1
-150,-156,-6,0.04,4,0
-225,-230,-5,0.022222222,2.222222222,0
-265,-260,5,-0.018867925,1.886792453,1
110,115,5,0.045454545,4.545454545,1
-125,-129,-4,0.032,3.2,0
185,190,5,0.027027027,2.702702703,0
-150,-168,-18,0.12,12,0
-195,-200,-5,0.025641026,2.564102564,0
-200,-210,-10,0.05,5,0
130,132,2,0.015384615,1.538461538,1
185,179,-6,-0.032432432,3.243243243,1
-210,-210,0,0,0,1
145,132,-13,-0.089655172,8.965517241,0
-115,-110,5,-0.043478261,4.347826087,0
-135,-158,-23,0.17037037,17.03703704,1
145,146,1,0.006896552,0.689655172,1
225,230,5,0.022222222,2.222222222,0
-105,-103,2,-0.019047619,1.904761905,1
195,173,-22,-0.112820513,11.28205128,0
-135,-130,5,-0.037037037,3.703703704,0
175,180,5,0.028571429,2.857142857,0
140,121,-19,-0.135714286,13.57142857,0
-120,-118,2,-0.016666667,1.666666667,0
-130,-132,-2,0.015384615,1.538461538,0
-120,-129,-9,0.075,7.5,0
165,171,6,0.036363636,3.636363636,1
165,154,-11,-0.066666667,6.666666667,0
100,-114,-214,-2.14,14,0
100,100,0,0,0,0
-270,-260,10,-0.037037037,3.703703704,1
180,180,0,0,0,0
-135,-146,-11,0.081481481,8.148148148,0
-290,-330,-40,0.137931034,13.79310345,1
155,163,8,0.051612903,5.161290323,0
-110,-111,-1,0.009090909,0.909090909,1
105,107,2,0.019047619,1.904761905,1
-250,-250,0,0,0,1
-190,-194,-4,0.021052632,2.105263158,0
100,-109,-209,-2.09,9,0
170,171,1,0.005882353,0.588235294,1
-255,-270,-15,0.058823529,5.882352941,1
-115,-135,-20,0.173913043,17.39130435,1
-145,-166,-21,0.144827586,14.48275862,0
-125,-123,2,-0.016,1.6,0
105,-126,-231,-2.2,29.52380952,0
130,126,-4,-0.030769231,3.076923077,1
165,140,-25,-0.151515152,15.15151515,1
145,128,-17,-0.117241379,11.72413793,0
-200,-220,-20,0.1,10,1
165,151,-14,-0.084848485,8.484848485,0
160,165,5,0.03125,3.125,0
135,124,-11,-0.081481481,8.148148148,0
-195,-190,5,-0.025641026,2.564102564,1
-235,-230,5,-0.021276596,2.127659574,1
115,117,2,0.017391304,1.739130435,0
-110,-107,3,-0.027272727,2.727272727,0
-110,-115,-5,0.045454545,4.545454545,1
115,102,-13,-0.113043478,11.30434783,0
-105,-107,-2,0.019047619,1.904761905,1
-145,-144,1,-0.006896552,0.689655172,0
-120,-128,-8,0.066666667,6.666666667,1
-125,-129,-4,0.032,3.2,1
240,217,-23,-0.095833333,9.583333333,0
145,132,-13,-0.089655172,8.965517241,0
-260,-270,-10,0.038461538,3.846153846,1
145,107,-38,-0.262068966,26.20689655,0
180,185,5,0.027777778,2.777777778,0
115,105,-10,-0.086956522,8.695652174,0
135,130,-5,-0.037037037,3.703703704,0
210,215,5,0.023809524,2.380952381,1
-110,-107,3,-0.027272727,2.727272727,0
-115,-110,5,-0.043478261,4.347826087,0
-135,-130,5,-0.037037037,3.703703704,1
125,-102,-227,-1.816,21.6,0
160,165,5,0.03125,3.125,0
-185,-190,-5,0.027027027,2.702702703,0
125,128,3,0.024,2.4,1
180,180,0,0,0,0
-235,-230,5,-0.021276596,2.127659574,0
-180,-180,0,0,0,1
160,145,-15,-0.09375,9.375,0
150,135,-15,-0.1,10,0
155,152,-3,-0.019354839,1.935483871,0
230,240,10,0.043478261,4.347826087,0
135,115,-20,-0.148148148,14.81481481,1
-105,-108,-3,0.028571429,2.857142857,1
120,112,-8,-0.066666667,6.666666667,1
145,140,-5,-0.034482759,3.448275862,0
165,156,-9,-0.054545455,5.454545455,0
125,120,-5,-0.04,4,1
105,102,-3,-0.028571429,2.857142857,1
105,-103,-208,-1.980952381,7.619047619,1
235,230,-5,-0.021276596,2.127659574,0
155,161,6,0.038709677,3.870967742,0
145,152,7,0.048275862,4.827586207,1
145,135,-10,-0.068965517,6.896551724,0
-120,-122,-2,0.016666667,1.666666667,1
-160,-169,-9,0.05625,5.625,1
-180,-200,-20,0.111111111,11.11111111,1
100,-105,-205,-2.05,5,0
130,128,-2,-0.015384615,1.538461538,0
110,111,1,0.009090909,0.909090909,0
-115,-113,2,-0.017391304,1.739130435,0
135,122,-13,-0.096296296,9.62962963,0
235,225,-10,-0.042553191,4.255319149,0
-195,-190,5,-0.025641026,2.564102564,1
220,230,10,0.045454545,4.545454545,1
110,110,0,0,0,1
-135,-140,-5,0.037037037,3.703703704,1
-105,-110,-5,0.047619048,4.761904762,0
-105,-120,-15,0.142857143,14.28571429,1
130,120,-10,-0.076923077,7.692307692,0
110,100,-10,-0.090909091,9.090909091,1
-180,-180,0,0,0,1
-105,-118,-13,0.123809524,12.38095238,1
-110,-120,-10,0.090909091,9.090909091,1
-165,-172,-7,0.042424242,4.242424242,0
-135,-146,-11,0.081481481,8.148148148,1
-110,-113,-3,0.027272727,2.727272727,0
225,230,5,0.022222222,2.222222222,0
-300,-310,-10,0.033333333,3.333333333,1
-260,-254,6,-0.023076923,2.307692308,1
-115,-114,1,-0.008695652,0.869565217,0
-160,-168,-8,0.05,5,1
-115,-119,-4,0.034782609,3.47826087,0
-105,-101,4,-0.038095238,3.80952381,1
-135,-135,0,0,0,0
-105,-111,-6,0.057142857,5.714285714,1
-165,-182,-17,0.103030303,10.3030303,1
-115,-113,2,-0.017391304,1.739130435,1
-110,-111,-1,0.009090909,0.909090909,1
-185,-210,-25,0.135135135,13.51351351,1
135,139,4,0.02962963,2.962962963,0
-190,-216,-26,0.136842105,13.68421053,1
200,205,5,0.025,2.5,0
-130,-132,-2,0.015384615,1.538461538,0
195,195,0,0,0,1
-150,-145,5,-0.033333333,3.333333333,0
-150,-146,4,-0.026666667,2.666666667,1
-185,-178,7,-0.037837838,3.783783784,0
135,140,5,0.037037037,3.703703704,0
-165,-193,-28,0.16969697,16.96969697,0
-101,-113,-12,0.118811881,11.88118812,1
111,106,-5,-0.045045045,4.504504505,1
-193,-204,-11,0.056994819,5.699481865,1
110,105,-5,-0.045454545,4.545454545,0
-180,-200,-20,0.111111111,11.11111111,1
-195,-224,-29,0.148717949,14.87179487,1
121,118,-3,-0.024793388,2.479338843,1
-330,-379,-49,0.148484848,14.84848485,1
-111,-111,0,0,0,1
-105,-109,-4,0.038095238,3.80952381,0
-242,-266,-24,0.099173554,9.917355372,1
-129,-135,-6,0.046511628,4.651162791,0
161,147,-14,-0.086956522,8.695652174,1
-191,-194,-3,0.015706806,1.570680628,1
150,140,-10,-0.066666667,6.666666667,1
-125,-122,3,-0.024,2.4,0
160,138,-22,-0.1375,13.75,1
155,161,6,0.038709677,3.870967742,1
110,113,3,0.027272727,2.727272727,0
-130,-134,-4,0.030769231,3.076923077,1
-140,-146,-6,0.042857143,4.285714286,1
115,119,4,0.034782609,3.47826087,1
-250,-260,-10,0.04,4,1
-145,-142,3,-0.020689655,2.068965517,0
-160,-162,-2,0.0125,1.25,1
-275,-270,5,-0.018181818,1.818181818,1
-110,-120,-10,0.090909091,9.090909091,0
-180,-176,4,-0.022222222,2.222222222,1
130,135,5,0.038461538,3.846153846,0
-160,-155,5,-0.03125,3.125,1
-180,-220,-40,0.222222222,22.22222222,1
-115,-110,5,-0.043478261,4.347826087,0
105,-110,-215,-2.047619048,14.28571429,1
-275,-280,-5,0.018181818,1.818181818,1
155,148,-7,-0.04516129,4.516129032,1
-140,-166,-26,0.185714286,18.57142857,1
-115,-112,3,-0.026086957,2.608695652,0
135,114,-21,-0.155555556,15.55555556,0
-360,-350,10,-0.027777778,2.777777778,1
150,154,4,0.026666667,2.666666667,1
250,220,-30,-0.12,12,1
100,101,1,0.01,1,0
165,151,-14,-0.084848485,8.484848485,0
180,190,10,0.055555556,5.555555556,0
-120,-132,-12,0.1,10,0
-225,-230,-5,0.022222222,2.222222222,1
125,120,-5,-0.04,4,0
145,149,4,0.027586207,2.75862069,0
105,-104,-209,-1.99047619,8.571428571,0
-135,-142,-7,0.051851852,5.185185185,0
-145,-154,-9,0.062068966,6.206896552,1
120,105,-15,-0.125,12.5,1
110,106,-4,-0.036363636,3.636363636,1
-115,-119,-4,0.034782609,3.47826087,1
-105,-118,-13,0.123809524,12.38095238,1
-110,-116,-6,0.054545455,5.454545455,1
100,100,0,0,0,0
-110,-108,2,-0.018181818,1.818181818,1
175,180,5,0.028571429,2.857142857,1
-135,-155,-20,0.148148148,14.81481481,1
-160,-190,-30,0.1875,18.75,1
100,-110,-210,-2.1,10,1
-110,-110,0,0,0,0
130,131,1,0.007692308,0.769230769,0
125,105,-20,-0.16,16,1
105,-106,-211,-2.00952381,10.47619048,1
155,160,5,0.032258065,3.225806452,1
-115,-120,-5,0.043478261,4.347826087,1
-130,-128,2,-0.015384615,1.538461538,0
165,163,-2,-0.012121212,1.212121212,0
-125,-121,4,-0.032,3.2,0
-225,-220,5,-0.022222222,2.222222222,0
125,122,-3,-0.024,2.4,0
105,101,-4,-0.038095238,3.80952381,0
150,135,-15,-0.1,10,1
120,112,-8,-0.066666667,6.666666667,1
-115,-117,-2,0.017391304,1.739130435,1
-115,-120,-5,0.043478261,4.347826087,1
-105,-104,1,-0.00952381,0.952380952,0
-115,-121,-6,0.052173913,5.217391304,1
-120,-124,-4,0.033333333,3.333333333,0
